nopces	noce	NOM
Iphis	Iphis	NAM
Ianthe	Ianthé	NAM
Hymen	Hymenée	NAM
avecques	avec	PRP
deesses	déesse	NOM
volla	voler	VER:simp
grant	grand	ADJ
Cyconie	Cyconie	NAM
ou	ou	KON
semons	semondre	VER:pper
estoit	être	VER:impf
Orpheus	Orphée	NAM
devoit	devoir	VER:impf
espouser	épouser	VER:infi
Eurydice	Eurydice	NAM
advenir	avenir	ADJ
diray	dire	VER:futu
alloit	aller	VER:infi
espouse	épouse	NOM
esbatant	ébattre	VER:ppre
ung	un	DET:ART
nudz	nu	ADJ
pre	pré	NOM
verdoyans	verdoyant	ADJ
illec	illuec	ADV
gaillart	gaillard	ADJ
Aristeus	Aristée	NAM
veit	voir	VER:simp
requist	requérir	VER:simp
tantost	tantôt	ADV
icelle	icel	PRO:DEM
luy	lui	PRO:PER
ne	ne	ADV:NEG
habandonner	abandonner	VER:infi
priere	prière	NOM
requeste	requête	NOM
sceust	savoir	VER:simp
cueur	coeur	NOM
aymoit	aimer	VER:impf
espoux	éspoux	NOM
ains	ains	ADV
eschapper	échapper	VER:infi
mist	mettre	VER:simp
fuyte	fuite	NOM
celluy	celui	PRO:DEM
suyvit	suivre	VER:simp
fuyoit	fuire	VER:impf
mordit	mordre	VER:simp
sceut	savoir	VER:simp
soubdaine	soudain	ADJ
deffortune	desfortune	NOM
avoit	avoir	VER:impf
doulousa	doulouser	VER:simp
ennuiable	ennuyeux	ADJ
seroit	être	VER:cond
racompter	raconter	VER:infi
eust	avoir	VER:simp
plouree	pleurer	VER:pper
veoir	voir	VER:infi
pourroir	pouvoir	VER:infi
ravoir	ravoir	VER:infi
recouvrer	retrouver	VER:infi
amye	ami	NOM
pourroit	pouvoir	VER:cond
infernaulx	infernal	NOM|ADJ
tenoit	tenir	VER:impf
touchoit	toucher	VER:impf
print	prendre	VER:simp
asprement	âprement	ADV
mon	mon	DET:POS
courroucea	courroucer	VER:simp
souffry	souffrir	VER:pper
estoie	être	VER:impf
icy	ici	AADV
succumbé	succomber	VER:pper
eurydice	Eurydice	NAM
Pluto	Pluton	NAM
Proserpine	Perséphone	NAM
ceans	céans	ADV
bouta	bouter	VER:simp
toutesfois	toutefois	ADV
voz	votre	DET:POS
tormens	tourment	NOM
esbahy	ébahir	VER:pper
doubta	douter	VER:simp
seur	sûr	ADJ
ceste	ce	PRO:DEM
doubte	doute	NOM
pry	prier	VER:impf
doulcement	doucement	ADJ
escoutez	écouter	VER:pres
moy	moi	PRO:PER
onc	onc	ADV
escouta	écouter	VER:simp
n'	ne	ADV:NEG
raurez	ravoir	VER:futu
finablement	finalement	ADV
faict	faire	VER:pper
cours	cour|cours	NOM
vostre	votre	DET:POS
melodieuseté	melodieuseté	NOM
ames	âme	NOM
estoient	être	VER:impf
oublierent	oublier	VER:simp
Tantalus	Tantale	NAM
soif	soif	NOM
Ixion	Ixion	NAM
pres	près	ADV
roe	roue	NOM
Sisyphus	Sisyphe	NAM
ius	jus	ADV
travailloit	travailler	VER:infi
Ticyus	Tityos	NAM
voultours	vautour	NOM
gisier	gosier	NOM
rongier	ronger	VER:infi
Belidiennes	Danaïdes	NAM
laissans	laisser	VER:ppre
espuiser	épuiser	VER:infi
royne	reine	NOM
povoit	pouvoir	VER:impf
roy	roi	NOM
pouvoit	pouvoir	VER:impf
maniere	manière	NOM
escondire	escondire	NOM
chose	chose	NOM
ilz	il	PRO:PER
demandast	demander	VER:simp
appellee	appeler	VER:pper
valee	valée	NOM
umbreuse	ombreux	NOM
Euridice	Eurydice	NAM
playe	plaie	NOM
receu	recevoir	VER:pper
joyeulx	joyeux	ADV
retornast	retourner	VER:subi
regardast	regarder	VER:subi
derriere	derrière	ADV
jusques	jusque	KON
fust	être	VER:subi
allast	aller	VER:subi
suyvroit	suivre	ADJ
ystroit	issir	VER:cond
roide	raide	ADJ
estroit	étrer	VER:impf
tenebreuse	ténébreux	ADJ
forvoyable	fourvoyable	ADJ
apres	apres	PRP
voye	voie	NOM
cheminerent	cheminer	VER:simp
jà	jà	ADJ
espris	épris	ADJ
desirant	désirant	VER:ppre
doubtant	douter	VER:ppre
suyvist	suivre	VER:subi
esvanouyst	évanouir	VER:subi
yeulx	oeil	NOM
tendit	tendre	VER:simp
Forment	fortement	ADV
plaignoit	plaindre	VER:impf
fermee	fermer	VER:ppre
gardoit	garder	VER:impf
dist	dire	VER:subi
plourant	pleurant	VER:ppre
boyre	boire	VER:impf
vivoit	vivre	VER:impf
sostenant	soutenir	VER:ppre
dueil	deuil	NOM
tenoit	tenir	VER:impf
felons	félon	ADJ
detenoient	détenir	VER:impf
chamberiere	chamberière	NOM
femenine	féminin	ADJ
desdaing	dédain	NOM
non	non	ADV:NEG
obstant	obstant	PRP
aymerent	aimer	VER:impf
jouyr	jouir	VER:infi
peurent	pouvoir	VER:simp
daignoit	daigner	VER:impf
ouyr	ouïr	VER:infi
plaignoient	plaindre	VER:impf
vindrent	venir	VER:simp
umbroier	ombrager	VER:infi
manieres	manière	NOM
pourprindrent	pourprendre	VER:simp
doulceur	douceur	NOM
ouyrent	ouïr	VER:simp
melodieux	mélodieux	ADJ
cest	ce	PRO:DEM
portans	portant	VER:ppre
fruitz	fruit	NOM
sortes	sorte	NOM
come	comme	KON
amandiers	amandier	NOM
lauries	laurier	NOM
nesfliers	néflier	NOM
corneilliers	cornouiller	NOM
meuries	mûrier	NOM
chesnes	chêne	NOM
fresnes	frêne	NOM
esrables	érable	NOM
peschiers	pêcher	NOM
genestries	geneste	NOM
cerisies	cerisier	NOM
aultres	autre	ADJ
basme	baume	NOM
aubespins	aubépine	NOM
Cybelle	Cybèle	NAM
Athys	Attis	NAM
esté	être	VER:pper
Phebus	Phébus	NAM
Entour	entour	ADV
dessusdit	dessus-dit	ADV
poete	poète	NOM
assemblerent	assembler	VER:simp
seoit	seoir	VER:impf
bestes	bête	NOM
sauvaiges	sauvage	ADJ
oyseaulx	oiseaux	NOM
attrempoit	attemprer	VER:impf
accordoit	accorder	VER:impf
sourdoit	sourdre	VER:impf
delectable	délectable	ADJ
Thrace	Thrace	NAM
armonieuse	harmonieuse	ADJ
delectoit	délecter	VER:impf
vecy	voici	PRP
faisoient	faire	VER:impf
bacchanalles	Bacchanalles	NAM
eschevellee	écheveler	VER:pper
Vecy	voici	PRP
despriseur	dépriseur	NOM
doulce	doux	ADJ
melodie	mélodie	NOM
cheut	cheoir	VER:simp
piedz	pied	NOM
mercy	merci	NOM
Adonc	adonc	ADV
forcenerie	forcenerie	NOM
faulces	faux	ADJ
plaines	plein	ADJ
virent	voir	VER:simp
sonnerent	sonner	VER:simp
buccines	buccine	NOM
affin	afin	ADV
ouyst	ouïr	VER:subi
peust	pouvoir	VER:subi
esmouvoir	émouvoir	VER:infi
getterent	jeter	VER:simp
espessement	épaissement	ADV
premieres	premier	NUM
Poete	poète	NOM
deporterent	déporter	VER:simp
doulx	doux	ADJ
pis	pi|pis	NOM
hayoient	haïr	VER:impf
avoient	avoir	VER:impf
cueurs	coeur	NOM
plains	plein	ADJ
enuie	ennuye	NOM
Oyseaulx	oiseau	NOM
serpens	serpent	NOM
saulvaigine	sauvagine	NOM
laisserent	laisser	VER:simp
nagueres	naguère	ADV
attraict	attraire	VER:pper
assemblé	assembler	VER:pper
vouloient	vouloir	VER:infi
rassaillirent	rassaillir	VER:simp
abbatirent	abattre	VER:simp
desvoyees	dévoyer	VER:pper
retournerent	retourner	VER:simp
legierement	legèrement	ADV
tendoit	tendre	VER:impf
aulcun	aucun	ADJ
meuldrirent	meurtrir	VER:simp
tuerent	tuer	VER:simp
Haa	hà	INT
ouye	ouïr	VER:pper
yssit	issir	VER:simp
ame	âme	NOM
pleurerent	pleurer	VER:simp
congoissoient	connaître	VER:impf
douloient	douloir	VER:impf
seicherent	sécher	VER:simp
espars	épars	ADJ
Hebrus	Hèbre	NAM
receut	recevoir	VER:pper
teste	tête	NOM
gectoit	jeter	VER:impf
plainct	plaindre	VER:pper
donnoit	donner	VER:infi
rivieres	rivière	NOM
resonnerent	résonner	VER:simp
respons	répons	NOM
chief	chef	NOM
lire	lyre	NOM
floterent	flotter	VER:simp
parfonde	profond	ADJ
parvindrent	parvenir	VER:simp
riviere	rivière	NOM
merveilleuse	merveilleux	ADJ
serpente	serpent	NOM
assist	asseoir	VER:simp
gueulle	gueule	NOM
bee	bée	ADJ
cuyda	cuider	VER:simp
demeurance	demeurance	NOM
filz	fils	NOM
rescourre	rescourre	VER:infi
devorer	dévorer	VER:infi
vallee	vallée	NOM
regnes	règne	NOM
paravant	paravant	ADV
veuz	voir	VER:pper
recongneut	reconnaître	VER:simp
compaignie	compagne	NOM
desiree	desirer	VER:pper
griefve	grief	ADJ
Orphée	Orphée	NAM
Pangée	Pangée	NAM
Rhésus	Rhésus	NAM
Gètes	Gètes	NAM
Hèbre	Hèbre	NAM
Orithye	Orithye	NAM
Actiade	Actiade	NAM
Ténare	Ténare	NAM
Mânes	Mânes	NAM
Érèbe	Érèbe	NAM
héros	héros	NOM
parents	parent	NOM
Cocyte	Cocyte	NAM
Styx	Styx	NAM
Euménides	Euménides	NAM
Cerbère	Cerbère	NAM
Averne	Averne	NAM
Orcus	Orcus	NAM
mois	mois	NOM
Strymon	Strymon	NAM
Philomèle	Philomèle	NAM
Vénus	Vénus	NAM
Tanaïs	Tanaïs	NAM
Riphée	Riphée	NAM
Cicones	Cicone	NAM
Bacchus	Bacchus	NAM
Crete	Crète	NAM
solemnels	solennel	ADJ
dura	durer	VER:simp
Dieux	dieu	NOM
Ciel	ciel	NOM
Pluton	Pluton	NAM
Tartare	Tartare	NAM
Échidne	Échidna	NAM
Méduse	Méduse	NAM
cahos	chaos	NOM
loix	loi	NOM
grace	grâce	NOM
chantoit	chanter	VER:impf
versoient	verser	VER:impf
Tantale	Tantale	NAM
Danaïdes	Danaïdes	NAM
Sisyphe	Sisyphe	NAM
premiere	premier	NUM
étoit	être	VER:impf
Héros	héros	NOM
aimoit	aimer	VER:impf
Cerbere	Cerbère	NAM
Hercule	Hercule	NAM
Olene	Olène	NAM
paroître	paraître	VER:impf
Léthée	Léthé	NAM
Mont	mont	NAM
Ida	Ida	NAM
Caron	Charon	NAM
Erebe	Érèbe	NAM
Hémus	Hémus	NAM
Aquilon	Aquilon	NAM
fidele	fidèle	ADJ
manquoit	manquer	VER:impf
Chaonie	Chaonie	NAM
Héliades	Héliades	NAM
Hyeuse	yeuse	NOM
Lotos	lotos	NOM
verd	vert	ADJ
Bruyeres	bruyère	NOM
Myrte	myrte	NOM
mere	mère	NOM
Atys	Atis	NAM
Cybele	Cybèle	NAM
attiroit	attirer	VER:impf
suivoient	suivre	VER:impf
Bacchantes	Bacchantes	NAM
apperçoit	appercevoir	VER:impf
Apollon	Apollon	NAM
Érinnys	Danaïdes	NAM
domine	dominer	VER:pres
formoient	former	VER:impf
présidoit	présider	VER:impf
lumiere	lumière	NOM
étoient	être	VER:impf
traînoient	traîner	VER:impf
préparoient	préparer	VER:impf
beches	bêche	NOM
sarcloirs	sarcloir	NOM
hoyaux	hoyau	NOM
prieres	prière	NOM
sacrileges	sacrilège	NOM
quitterent	quitter	VER:simp
Naïades	Naïade	NAM
Hebre	Hèbre	NAM
rouloient	rouler	VER:impf
paroît	paraître	VER:pres
promenent	promener	VER:pres
précede	préceder	VER:pres
Nopcier	Hyménée	NAM
espousailles	épousailles	NOM
jetta	jeter	VER:simp
appeloit	appeler	VER:impf
verité	vérité	NOM
esclairé	éclairer	VER:pper
allegresse	allégresse	NOM
prononça	prononcer	VER:simp
solemnelles	solennel	ADJ
accoustumé	accoutumer	VER:pper
festes	fêtes	NOM
fist	faire	VER:simp
presage	présage	NOM
promist	promettre	VER:simp
succés	succès	NOM
assistoit	assister	VER:impf
sembloit	sembler	VER:impf
petillant	pétiller	VER:ppre
faisoit	faire	VER:impf
mariee	mariée	NOM
égayant	égayer	VER:ppre
Nimphes	Nymphe	NAM
cheoir	cheoir	VER:infi
plaincts	plaindre	VER:pper
resolut	résoudre	VER:simp
divinitez	divinité	NOM
avoyent	avoir	VER:impf
precipice	précipice	ADJ
Laconie	Laconie	NAM
costé	côté	NOM
Tenare	Ténare	NAM
legeres	léger	ADJ
parmy	parmi	PRP
tenebres	tenèbre	NOM
trosne	trône	NOM
espouventable	épouvantable	ADJ
presence	présence	NOM
resonner	résonner	VER:infi
accens	accent	NOM
souspirs	soupir	NOM
tesmoings	témoin	NOM
subjet	sujet	NOM
tremble	trembler	VER:pres
tenebreux	ténébreux	NOM
desir	désir	NOM
enschainer	enchaîner	VER:infi
vien	venir	VER:pres
recerche	rechercher	VER:pres
Helas	hélas	INT
agreables	agréable	ADJ
beautez	beauté	NOM
esclorre	éclore	VER:infi
hyver	hiver	NOM
delices	délices	NOM
devois	devoir	VER:impf
gouster	goûter	VER:infi
cognuë	connaître	VER:pper
hault	haut	ADJ
sçay	savoir	VER:subi
croy	croire	VER:pres
ouy	ouïr	VER:pres
larcin	larcin	NOM
fistes	faire	VER:subi
Ceres	Cérès	NAM
esprouvé	éprouver	VER:pper
joincts	joindre	VER:pper
suplie	supplier	VER:pres
effroy	effroi	NOM
renduë	rendre	VER:pper
renoüé	renouer	VER:pper
aye	avoir	VER:subi
tost	tôt	ADV
fault	falloir	VER:pres
Acheron	Achéron	NAM
peult	pouvoir	VER:pres
esgarer	égarer	VER:infi
retraicte	retraite	NOM
necessité	nécessité	NOM
ameine	amener	VER:pres
sçaurez	savoir	VER:pres
jouysse	jouir	VER:pres
delicieux	délicieux	ADJ
embrassemens	embrassement	NOM
arrestez	arrêter	VER:pres
resolu	résoudre	VER:pper
vivans	vivant	VER:ppre
faictes	faire	VER:pres
separe	séparer	VER:pres
plainctive	plaintif	ADJ
marioit	marier	VER:impf
despouillees	dépouiller	VER:pper
estoyent	être	VER:impf
esteindre	éteindre	VER:infi
levres	lèvre	NOM
rouë	roue	NOM
Tytie	Tityos	NAM
becquetter	béqueter	VER:infi
Belus	Bélus	NAM
peinerent	peiner	VER:simp
Sysiphe	Sisyphe	NAM
ayse	aise	NOM
tousjours	toujours	ADV
reyne	reine	NOM
obeissent	obéir	VER:pres
prioyt	prier	VER:impf
appellerent	appeler	VER:simp
pourmenoit	pourmener	VER:impf
descenduës	descendre	VER:pper
retourneroit	retourner	VER:impf
demeureroit	demeurer	VER:cond
resjouy	réjouir	VER:pres
sçavoir	savoir	VER:infi
presques	presque	ADV
devenoit	devenir	VER:impf
espaisse	épais	ADJ
fumee	fumée	NOM
desja	déjà	ADV
craincte	crainte	NOM
suivoit	suivre	VER:impf
esgaree	égarer	VER:pper
desireux	désireux	NOM
veüe	voir	VER:pper
esvanoüyssoit	évanouir	VER:impf
Miserable	misérable	ADJ
veid	voir	VER:simp
dequoy	de quoi	PRP
laschant	lâcher	VER:ppre
foible	faible	ADJ
souspir	soupir	NOM
rechef	rechef	NOM
Parques	Parque	NAM
esmeut	émouvoir	VER:pper
estonné	étonner	VER:pper
testes	tête	NOM
enchaisnees	enchaîner	VER:pper
gaigner	gagner	VER:infi
osté	ôter	VER:pper
millefois	millefois	ADV
detesta	détester	VER:simp
decrets	décret	NOM
recerchent	rechercher	VER:pres
refusees	refuser	VER:pper
eschauffa	échauffer	VER:simp
cherir	chérir	VER:infi
detestable	détestable	ADJ
Thraces	Thraces	NAM
eslançoit	élancer	VER:impf
enchantez	enchanter	VER:pres
entourerent	entourer	VER:simp
apporterent	apporter	VER:simp
fraischeur	fraîcheur	NOM
portez	porter	VER:pres
forces	force	NOM
charmeresses	charmeur	ADJ
hestres	hêtre	NOM
Fresnes	frêne	NOM
Sapins	sapin	NOM
saulx	saule	NOM
esquels	èsquel	KON
Nimphe	Nymphe	NAM
muëe	muer	VER:pper
bouys	buis	NOM
Bruieres	bruyère	NOM
Meurtes	myrte	NOM
seps	cep	NOM
arbouces	arbousier	NOM
fruict	fruit	NOM
coronnent	couronner	VER:pres
cherit	chérir	VER:pres
Prestre	prêtre	NOM
escorce	écorce	NOM
veu	voir	VER:pper
Voicy	voici	ADV
celuy	celui	PRO:DEM
mesprise	mépriser	VER:pres
picque	pique	NOM
suspenduë	suspendre	VER:pper
arrestee	arrêter	VER:pper
sortoit	sortir	VER:impt
croist	croître	VER:simp
inspirees	inspirer	VER:pper
Poëte	poète	NAM
flustes	flûte	NOM
hurlemens	hurlement	NOM
empesche	empêcher	VER:pres
effect	effet	NOM
lor	leur	PRO:PER
charmees	charmer	VER:pper
commencerent	commencer	VER:simp
enragees	enrager	VER:pper
deffirent	défier	VER:simp
premierement	premièrement	ADV
oyseaux	oiseau	NOM
estoyant	estoyer	VER:ppre
demeurees	demeurer	VER:pper
tesmoigner	témoigner	VER:infi
jetterent	jeter	VER:simp
mesme	même	ADV
hybou	hibou	NOM
becqueter	bequeter	VER:infi
void	voir	VER:simp
Amphitheatre	amphithéâtre	NOM
jetter	jeter	VER:infi
proye	proie	NOM
bastons	bâton	NOM
enveloppez	envelopper	VER:pres
fueilles	feuille	NOM
païsans	paysan	NOM
bechent	bêcher	VER:pres
aupres	auprès	ADV
espouvente	épouvante	NOM
penible	pénible	ADJ
faircloirs	faircloir	NOM
rasteaux	râteau	NOM
parolles	parole	NOM
estre	être	NOM
detourner	détourner	VER:infi
esmeu	émouvoir	VER:pper
autresfois	autrefois	ADV
animoit	animer	VER:impf
affligez	affliger	VER:pres
Orphee	Orphée	NAM
boys	bois	NOM
forests	forêt	NOM
traisnees	traîner	VER:pper
toy	toi	PRO:PER
poserent	poser	VER:simp
accreurent	accroître	VER:simp
Naiades	Naïade	NAM
verds	vert	ADJ
vestemens	vêtement	NOM
lascherent	lâcher	VER:simp
espaules	épaule	NOM
maistre	maître	NOM
dissipez	dissiper	VER:pres
forest	forêt	NOM
deschiré	deschirer	VER:pper
jettees	jeter	VER:pper
privee	priver	VER:pper
mouvemens	mouvement	NOM
resonna	résonner	VER:simp
respondit	répondre	VER:simp
Neptune	Neptune	NAM
pousserent	pousser	VER:simp
Isle	île	NOM
Lesbos	Lesbos	NAM
apperceu	apperçevoir	VER:pper
arresta	arrêter	VER:simp
lecher	lécher	NOM
pere	père	NOM
Poëtes	poète	NOM
recognut	reconnaître	VER:simp
cercha	chercher	VER:simp
trouvee	trouver	NOM
chams	champ	NOM
Élysees	Élysée	ADJ
estroictement	étroitement	ADV
desirer	désirer	VER:infi
promenerent	promener	VER:simp
embrassez	embrasser	VER:pres
marcherent	marcher	VER:simp
veue	vue	NOM
Hymenée	Hymenée	NAM
Robbe	robe	NOM
aïant	avoir	VER:ppre
prioit	prier	VER:impf
assista	assister	VER:simp
profera	proférer	VER:simp
presagent	présager	VER:pres
jettoit	jeter	VER:impf
repondit	répondre	VER:simp
presages	présage	NOM
couroit	courir	VER:impf
chere	chère	NOM
taché	tâcher	VER:pper
Divinitez	divinité	NOM
sejour	séjour	NOM
presenté	présenter	VER:pper
regnent	régner	VER:pres
regnez	régner	VER:pres
respire	respirer	VER:pres
enchainer	enchaîner	VER:infi
amene	amener	VER:pres
sai	savoir	VER:pres
Enlevement	enlèvement	NOM
veritable	véritable	ADJ
Parque	Parque	NAM
tems	temps	NOM
carriere	carrière	NOM
delai	délai	NOM
repandoient	répandre	VER:infi
dechiroient	déchirer	NOM
impitoïablement	impitoyablement	ADV
Titye	Tityos	NAM
donnerent	donner	VER:simp
vuide	vide	ADJ
Furies	Danaïdes	NAM
ordonnerent	ordonner	VER:simp
contrevenoit	contrevenir	VER:impf
toûjours	toujours	NOM
escarpez	escarper	VER:pper
regnoient	régner	VER:impf
legere	léger	ADJ
auroit	avoir	VER:impf
Roïaume	royaume	NOM
Émus	Hémus	NAM
regne	règne	VER:pres
écoulerent	écouler	VER:simp
quoiqu'il	quoique il	KON
sentimens	sentiment	NOM
indifference	indifférence	NOM
fidelité	fidélité	NOM
rendoit	rendre	VER:impf
Bui	buïs	NAM
Myrthes	myrte	NOM
entrelassez	entrelacer	VER:pper
Seps	cep	NOM
herissées	hérisser	VER:pper
Mere	mère	NAM
Attis	Attis	VER:simp
feroces	féroce	NOM
apperçurent	appercevoir	VER:simp
mepris	mépris	NOM
reparation	réparation	NOM
regner	régner	VER:infi
côtez	côté	NOM
servoient	servir	VER:impf
seroient	être	VER:impf
Flutes	flûte	NOM
Serpens	serpent	NOM
apperçoivent	appercevoir	VER:pres
hazard	hasard	NOM
Païsans	paysan	NOM
labouroient	labourer	VER:impf
travailloient	travailler	VER:impf
effraïez	effrayer	VER:pper
entendoient	entendre	VER:impf
massacrerent	massacrer	VER:simp
voïant	voir	VER:ppre
repandirent	répandre	VER:simp
voïoit	voir	VER:impf
entrainoit	entraîner	VER:impf
Echos	Écho	NAM
repetoient	répéter	VER:impf
ouvroit	ouvrir	VER:impf
Or­phée	Or­phée	NAM
châtimens	châtiment	NOM
Peine	peiner	VER:pres
légère	léger	ADJ
comparaison	comparaison	NOM
Gète	Gète	NAM
Erèbe	Érèbe	NOM
légères	léger	ADJ
con­fondus	con­fondre	VER:pper
enfans	enfant	NOM
Cer­bère	Cer­bère	NAM
Pro­serpine	Pro­serpine	NOM
assiégent	assiéger	VER:pres
Riphées	Riphées	NAM
Eury­dice	Eury­dice	NAM
per­fides	per­fide	ADJ
Julia	Julia	NAM
Alfred	Alfred	NAM
chenets	chenet	NOM
cordelière	cordelière	NOM
t	t	SYM
Ne	ne	ADV:NEG
chatte	chat	NOM
M	monsieur	ABR
Perrault	Perrault	NAM
Grecs	grec	NOM
Œagre	Œagre	NAM
Calliope	Calliope	NAM
Arthur	Arthur	NAM
boulevart	boulevard	NOM
Aristée	Aristée	NAM
Troie	Troie	NAM
Jean	Jean	NAM
Eve	Ève	NAM
—	—	PUN
O	ô	INT
Virgile	Virgile	NAM
Félicie	Félicie	NAM
groom	groom	NOM
Aristées	Aristée	NAM
Eurydices	Eurydice	NAM
Orphées	Orphée	NAM
Coquardeau	Coquardeau	NAM
Joseph	Joseph	NAM
Phrudhomme	Phrudhomme	NAM
robbe	robe	NOM
petilloit	pétiller	VER:impf
promenoit	promener	VER:impf
resisté	résister	VER:pper
pû	pouvoir	VER:pper
connoît	connaître	VER:impf
sçai	savoir	VER:simp
soûmis	soumettre	VER:pper
Belides	Danaïades	NAM
songerent	songer	VER:simp
Sisiphe	Sisyphe	NAM
appeller	appeler	VER:infi
boittant	boiter	NOM
morduë	mordre	VER:pper
revoqueroit	révoquer	VER:cond
approchoit	approcher	VER:impf
engloûtie	engloutir	VER:pper
venoit	venir	VER:impf
avanture	aventure	NOM
devroient	devoir	VER:cond
merite	mérite	NOM
ayent	avoir	VER:ppre
perduë	perdre	VER:pper
falut	falloir	VER:simp
destinée	destinée	NOM
meritez	mériter	VER:ppre
orguëil	orgueil	NOM
inspiroit	inspirer	VER:impf
preferoit	préférer	VER:impf
immortelles	immortel	NOM
amoient	aimer	VER:impf
aprés	après	ADV
Aquilons	Aquilon	NAM
foiblesses	faiblesses	NOM
representé	répresenter	VER:pper
vangeoient	venger	VER:impf
desespoir	désespoir	NOM
erables	érable	NOM
lotos	lotos	NOM
bui	buis	NOM
bruyeres	bruyère	NOM
myrthes	myrte	NOM
herissée	hérisser	VER:pper
cheri	chéri	ADJ
Atis	Attis	NAM
excelloit	exceller	VER:impf
aprit	apprendre	VER:simp
vivoient	vivre	VER:impf
regler	régler	VER:infi
charmoit	charmer	VER:impf
vêtuës	vêtir	VER:pper
apperceurent	appercevoir	VER:simp
feüilles	feuille	NOM
garderent	garder	VER:simp
battemens	battement	NOM
entouroient	entourer	VER:impf
porterent	porter	VER:simp
attrouperent	attrouper	VER:simp
motes	motte	NOM
charruë	charrue	NOM
apperçû	appercevoir	VER:pper
abandonnerent	abandonner	VER:simp
charruës	charrue	NOM
instrumens	instrument	NOM
dépoüillez	dépouiller	VER:ppre
deüil	deuil	NOM
vû	voir	VER:pper
Elysées	Élysée	NAM
apprehension	appréhension	NOM
Crète	Crète	NAM
Om­bres	om­bre	NOM
Bélus	Bélus	NAM
Olénus	Olène	NAM
Léthéa	Léthé	NAM
alimens	aliment	NOM
aquilons	Aquilon	NAM
baie	baie	NOM
azurée	azuré	ADJ
Ménades	Ménade	NAM
Char­més	char­mer	VER:pper
Jupiter	Jupiter	NAM
tribut	tribut	NOM
Méthymne	Méthymne	NAM
presse	presser	VER:pres
Hyménée	Hyménée	NAM
Perséphone	Perséphone	NAM
mânes	Mânes	NAM
Tityus	Tityos	NAM
Lethæa	Léthé	NAM
Achéron	Achéron	NAM
Cérès	Cérès	NAM
baies	baie	NOM
Cybèle	Cybèle	NAM
bacchantes	Bacchantes	NAM
poëte	poète	NOM
Phrygie	Phrygie	NAM
orphée	Orphée	NAM
Ebre	Hèbre	NAM
appelloit	appeler	VER:impf
pleuroit	pleurer	VER:impf
accouroient	accourer	VER:impf
pâlissans	pâlissant	ADJ
meres	mère	NOM
peres	père	NOM
Alecton	Alecton	NAM
revenoit	revener	VER:impf
précédoit	précéder	VER:impf
proserpine	Perséphone	NAM
arrachoit	arracher	VER:impf
secondoit	seconder	VER:impf
flattoit	flatter	VER:impf
entraînoit	entraîner	VER:impf
pardonnoit	pardonner	VER:impf
resaisir	ressaisir	VER:infi
misere	misère	NOM
aducissoit	aducir	VER:impf
inclinoient	incliner	VER:impf
philomele	Philomèle	NAM
couvroit	couvrir	VER:impf
Hyperborées	hyperborée	ADJ
reprochoit	reprocher	VER:impf
efforçoient	efforcer	VER:impf
mysteres	mystères	NOM
murmuroit	murmurer	VER:impf
Échos	Écho	NAM
répétoient	répéter	VER:impf
dryade	Dryade	NAM
Koré	Koré	NAM
Hyperboréens	hyperboréen	ADJ
règles	règle	NOM
Talaon	Talaon	NAM
Ionie	Ionie	NAM
ménade	Ménade	NAM
Titans	Titan	NAM
Oïoh	Oïoh	NAM
coryphée	Coryphée	NAM
Dorien	Dorien	NAM
Êtres	être	NOM
Zeus	Jupiter	NAM
Zagreus	Zagreus	NAM
Psyché	Psyché	NAM
Éther	Éther	NAM
Éros	Éros	NAM
Ogen	Ogen	NAM
Péplos	Péplos	NAM
peplos	Péplos	NAM
Peplos	Péplos	NAM
Dionysos	Bacchus	NAM
Até	Até	NAM
horcos	Horcos	NAM
Érinnyes	Danaïdes	NAM
Harpies	Harpie	NAM
Hadès	Pluton	NAM
Dionys	Bacchus	NAM
Pythie	Pythie	NAM
Omphalos	Omphale	NAM
Bacchus	Bacchus	NAM
Omphale	Omphale	NAM
bacchante	Bacchantes	NAM
Corybantes	Corybantes	NAM
cybèle	Cybèle	NAM
dionys	Bacchus	NAM
dionysos	Bacchus	NAM
Démèter	Démèter	NAM
apollon	Apollon	NAM
Satyres	Satyres	NAM
Musagètes	musagète	ADJ
lauré	laurer	VER:pper
Veritablement	véritablement	ADV
petiller	pétiller	VER:infi
secoüa	secouer	VER:simp
menaçoient	menacer	VER:impf
succez	succès	NOM
celestes	céleste	NOM
voiant	voir	VER:ppre
écoutoit	écouter	VER:impf
aiant	avoir	VER:ppre
cét	ce	PRO:DEM
vrayes	vrai	ADJ
temeraire	téméraire	ADJ
croi	croire	VER:pres
menaçans	menaçant	ADJ
effroiable	effroyable	ADJ
mene	mener	VER:pres
derniere	dernier	ADJ
retraite	retrait	ADJ
possedez	posséder	VER:pres
vêcu	vivre	VER:pper
oüir	ouïr	VER:infi
vaincuës	vaincre	VER:pper
demandoient	demander	VER:impf
craignoit	craigner	VER:impf
brûloit	brûler	VER:impf
évanoüit	évanouir	VER:simp
dequoi	dequoi	PRP
aimoient	aimer	VER:impf
soûtient	soutenir	VER:pres
desespere	désespérer	VER:pres
Charon	Charon	NAM
crüauté	cruauté	NOM
Emus	Hémus	NAM
receurent	recevoir	VER:simp
autheur	auteur	NOM
sommes	être	VER:pres
raporter	rapporter	VER:infi
loüer	louer	VER:infi
payeroit	payer	VER:cond
gueres	guères	ADV:NEG
loüanges	louange	NOM
picquer	piquer	VER:infi
piqueure	piqure	NOM
loüable	louable	ADJ
perdoit	perdre	VER:impf
feignant	feindre	VER:ppre
avoüe	avouer	VER:pres
devroit	devoir	VER:cond
soûmettre	soumettre	VER:infi
voi	voir	VER:pres
surquoi	surquoi	PRP
mutüelle	mutuel	ADJ
resprésente	représenter	VER:pres
rendroit	rendre	VER:cond
sçache	savoir	VER:subp
entierement	entièrement	ADV
Ariston	Aristée	NAM
passageres	passager	ADJ
veritables	véritable	ADJ
ramene	ramener	VER:pres
sçait	savoir	VER:pres
regle	règle	NOM
Loix	loi	NOM
veritablement	véritablement	ADV
Thesprotide	Thesprotide	NAM
évoquoit	évoquer	VER:impf
Fantôme	fantôme	NOM
presenta	présenter	VER:simp
portoit	porter	VER:impf
Lethée	Léthé	NAM
metamorphosé	métamorphoser	VER:pper
Hestres	hêtre	NOM
dépoüillé	dépouiller	VER:pper
appellé	appeler	VER:pper
Cyparisse	Cyparisse	NAM
revétit	revêtir	VER:simp
sauver	sauver	VER:infi
revétuës	revêtir	VER:pper
jettée	jeter	VER:pper
declarée	déclarer	VER:pper
excez	excès	VER:pres
servoit	servir	VER:impf
auroient	avoir	VER:impf
entour	entour	ADV
amphitheatre	amphithéâtre	NOM
frapent	frapper	VER:pres
füir	fuir	VER:infi
tüerent	tuer	VER:simp
Marise	Marise	NAM
inoüie	inouï	ADJ
laissoit	laisser	VER:impf
entraînoient	entraîner	VER:impf
repondirent	répondre	VER:simp
lécher	lécher	VER:infi
devala	dévaler	VER:simp
veus	voir	VER:pper
Élysées	Élysée	NAM
miserable	misérable	ADJ
confidére	confidérer	VER:pres
merites	mérite	NOM
represente	représenter	VER:pres
combatent	combattre	VER:pres
voudroit	vouloir	VER:cond
Amphion	Amphion	NAM
Egyptiens	égyptien	NOM
Theologie	théologie	NOM
remedes	remède	NOM
modele	modèle	NOM
méchans	méchant	ADJ
assassinerent	assassiner	VER:simp
presente	présenter	VER:pres
voudroient	voudrer	VER:impf
arrivoit	arriver	VER:impf
Poësie	poésie	NOM
reputation	réputation	NOM
Ciconiens	Ciconien	NAM
naiades	Naïade	NAM
doie	devoir	VER:pres
Érynnis	Danaïdes	NAM
Bérécynthe	Bérécynthe	NAM
enfflée	enfler	VER:pper
rententirent	rententir	VER:simp
gîsent	gésir	VER:pres
sacriléges	sacrilège	VER:subp
hèbre	Hèbre	NAM
Méthymnéenne	méthymnéen	ADJ
Phébus	Phébus	NAM
Athénienne	athénien	ADJ
Vesper	Vesper	NAM
quittes	quitter	VER:pres
mariées	marié	NOM
Rhiphée	Riphée	NAM
Euménide	Euménides	NAM
Strimon	Strymon	NAM
Èbre	Hèbre	NAM
orphé	Orphée	NAM
Venus	Vénus	NAM
conduisoit	conduiser	VER:impf
esclat	éclat	NOM
pluton	Pluton	NAM
loy	loi	NOM
bizare	bizarre	ADJ
essaioit	essayer	VER:impf
gratieux	gracieux	ADJ
sceu	savoir	VER:pper
reparer	réparer	VER:infi
gage	gager	VER:pres
seulle	seul	ADJ
ay	avoir	VER:pres
temoin	témoin	NOM
enflammé	enflammer	VER:pper
Attens	attendre	VER:pres
Mégere	Mégère	NAM
Cythere	Cythère	NAM
ainsy	ainsi	ADV
remorts	remord	NOM
sceus	savoir	VER:pres
Vole	voler	VER:pres
Devoient	devoir	VER:impf
separer	séparer	VER:infi
legitime	légitime	ADJ
scaurois	savoir	VER:impf
nostre	notre	DET:POS
recompense	récompense	NOM
indolense	indolence	NOM
eschappe	échapper	VER:impf
desirs	désir	NOM
impetueux	impétueux	ADJ
tache	tâcher	VER:pres
connoittre	connaître	VER:infi
aujourd'huy	aujourd'hui	ADV
Pénée	Pénée	NAM
aperçoit	apercevoir	VER:pres
dryades	Dryade	NAM
Gélon	Gélon	NAM
cerbère	Cerbère	NAM
étouffée	étouffer	VER:pper
vogue	voguer	VER:pres
éther	Éther	NAM
Bélides	Danaïdes	NOM
Olénos	Olène	NAM
Titan	Titan	NAM
Érinye	Danaïdes	NAM
Juppiter	Jupiter	NAM
Olympe	Olympe	NAM
approchoient	approcher	VER:impf
Alcide	Alcide	NAM
Léthoea	Léthé	NAM
terminoit	terminer	VER:impf
myrthe	myrte	NOM
Pallas	Pallas	NAM
traçoient	traçer	VER:impf
ouvroient	ouvrer	VER:impf
apprivoisoit	apprivoiser	VER:impf
funebres	funèbre	ADJ
isle	île	NOM
leche	lécher	VER:pres
Eu­rydice	Eu­rydice	NAM
Rhesus	Rhésus	NAM
Orithyie	Orithyie	NAM
re­grets	régret	NOM
riphéennes	riphéen	ADJ
Paul	Paul	NAM
Drouot	Drouot	NAM
Éliacin	Éliacin	NAM
RÉGNIER	régnier	VER:infi
sphinx	Sphinx	NAM
aille	aller	VER:subp
Histoire	histoire	NOM
naïade	Naïade	NAM
hamadryade	Hamadryade	NAM
oy	ouïr	VER:pper
Yphis	Iphis	NAM
prist	prendre	VER:simp
ala	aller	VER:simp
janne	jaune	ADJ
Lyconie	Lyconie	NAM
estrange	étrange	ADJ
Erudice	Eurydice	NAM
jone	jeune	ADJ
aix	air	NOM
aporter	apporter	VER:infi
ioyeusté	joyeusté	NOM
doleur	douleur	NOM
mescheance	méchance	NOM
espousez	épouser	VER:pper
aincorres	encore	ADV
este	être	VER:pper
contray	conter	VER:futu
aloit	aller	VER:impf
espeuse	épouse	NOM
piez	pied	NOM
verdoians	verdoyant	ADJ
voult	vouloir	VER:simp
attorder	accorder	VER:infi
requeste	requête	NOM
feist	être	VER:simp
Ains	ains	KON
fuitte	fuite	NOM
cestui	celui	PRO:DEM
suivir	suivre	VER:infi
seut	savoir	VER:simp
complaindy	complaindre	VER:simp
dolousa	doulouser	VER:simp
plourée	pleurer	VER:pper
veioir	voir	VER:infi
porroit	pouvoir	VER:cond
tele	tel	ADJ
chartre	chartre	NOM
creature	créature	NOM
tempre	tempre	ADV
loist	loisir	VER:simp
retraire	retraire	VER:infi
yci	ici	ADV
assayer	assayer	VER:infi
tourmens	tourment	NOM
cer	car	KON
Maiz	mais	KON
avoie	avoir	VER:impf
quers	quérir	VER:pres
ja	jà	ADV
Ung	un	DET:ART
blescha	blesser	VER:simp
morut	mourir	VER:simp
cuiday	cuider	VER:pres
porroye	pouvoir	VER:futu
assault	assaut	NOM
tressouverain	très-souverain	ADJ
feistes	faire	VER:subi
assamblement	assemblement	NOM
ravistes	ravir	VER:subi
dommaige	dommage	NOM
povez	pouvoir	VER:pres
heritage	héritage	NOM
pardurablement	perdurablement	ADV
mortelz	mortel	ADJ
derrenier	dernier	ADJ
Ainsy	ainsi	ADV
lais	lais	NOM
sy	si	ADV
docement	doucement	ADV
paines	peine	NOM
lez	les	DET:ART
Siziphus	Sisyphe	NAM
traveilloit	travailler	VER:impf
Ticius	Tityos	NAM
ostoirs	vautour	NOM
uigier	gosier	NOM
epuisier	épuiser	VER:infi
seaulx	seau	NOM
fons	fond	NOM
Ymediennes	Danaïdes	NAM
plouroient	pleurer	VER:impf
oyoient	ouïr	VER:impf
oncsques	onques	ADV
roynne	reine	NOM
commanderent	commander	VER:simp
ioyeulx	joyeux	ADJ
veyt	voir	VER:simp
baillie	baillir	VER:pper
jamaiz	jamais	ADV
retournast	retourner	VER:subi
tenement	tènement	NOM
voise	voie	NOM
ysceroit	issir	VER:impf
durté	dureté	NOM
obscurté	obscurité	NOM
fourvoiable	fourvoyable	ADJ
ia	jà	ADV
prez	près	ADV
espriz	esprit	NOM
suivist	suivre	VER:subi
incontment	incontement	ADV
esvanuy	évanouir	VER:pper
infer	enfer	NOM
tendy	tendre	VER:pper
departi	départir	VER:pper
derrain	dernier	ADJ
rendy	rendre	VER:simp
apaine	à peine	ADV
entendi	entendre	VER:simp
complaindi	complaindre	VER:simp
entreroit	entrer	VER:cond
mengier	manger	VER:infi
soustenant	soutenir	VER:ppre
meschine	meschine	NOM
fuiant	fuir	VER:ppre
reffus	refus	NOM
scay	savoir	VER:pres
pourquoy	pourquoi	ADV
mesavenu	mésavenir	VER:pper
hat	haïr	VER:simp
Nonpourquant	nonpourquant	ADV
pluiseurs	plusieurs	ADJ
amerent	aimer	VER:simp
iouyr	jouir	VER:infi
complaindirent	complaindre	VER:simp
cellui	celui	PRO:DEM
eprist	éprendre	VER:simp
ceulx	celui	PRO:DEM
iones	jeune	ADJ
damoiseaulx	damoiseau	NOM
deduit	déduit	NOM
entachiez	entâcher	VER:impf
hystoire	histoire	NOM
puet	pouvoir	VER:simp
sicomme	sicomme	ADV
deporter	déporter	VER:infi
masle	mâle	NOM
usoit	user	VER:impf
Sy	si	KON
perdy	perdre	VER:simp
oyr	ouïr	VER:infi
oultre	outre	ADV
cruele	cruel	ADJ
ile	il	PRO:PER
mordy	mordre	VER:pper
descendi	descendre	VER:pper
parquoy	parquoi	ADV
ploura	pleurer	VER:simp
fouy	fouir	VER:pper
verdoiant	verdoyant	ADJ
umbre	ombre	NOM
umbroyer	ombroyer	VER:infi
alies	alise	NOM
mespliers	néflier	NOM
chiphos	chiphos	NOM
fresnses	frêne	NOM
cornilliers	cornouiller	NOM
mouriers	mûriers	NOM
plasnes	plâne	NOM
errables	érable	ADJ
genestriers	genêt	NOM
pluseurs	plusieurs	ADJ
pardurables	perdurables	ADJ
Aincorres	encore	ADV
aubespines	aubépine	NOM
Cibelle	Cybèle	NAM
mena	mener	VER:simp
Athin	Attis	NAM
muez	muer	VER:pres
Cyprez	Cyparisse	NAM
amoit	aimer	VER:impf
[	[	PUN
assenbla	assembler	VER:simp
delitable	délitable	ADJ
acordees	accorder	VER:pper
recorder	reccorder	VER:infi
grans	grand	ADJ
cieulx	ciel	NOM
Jouvenceaulx	jouvenceau	NOM
montaigne	montagne	NOM
seioit	seoir	VER:impf
aggreables	agréable	ADJ
meismes	même	ADV
esmouvoient	émouvoir	VER:impf
sieuvoient	suivre	VER:impf
melodieus	mélodieux	ADJ
sonnoit	sonner	VER:impf
enchantoit	enchanter	VER:impf
felonne	félon	ADJ
raige	rage	NOM
couvers	couvert	ADJ
sauvaige	sauvage	ADJ
foursennees	forcené	ADJ
cop	coup	NOM
attraioit	attraire	VER:impf
faulce	faux	ADJ
haulte	haut	ADJ
escrierent	écrier	VER:simp
disans	dire	VER:ppre
mauvaiz	mauvais	ADJ
traittre	traître	NOM
iouvenceaulx	jouvenceau	NOM
compaignes	compagne	NOM
desprise	dépriser	VER:pres
Adont	adonc	ADV
lancha	lancer	VER:simp
dart	dard	NOM
blecha	blesser	VER:simp
recueilla	recueillir	VER:simp
hanste	hampe	NOM
chey	choir	VER:pper
deruerie	druerie	NOM
faulses	faux	ADJ
bruismes	bruit	NOM
aneantir	anéantir	VER:infi
oyst	ouïr	VER:simp
oyrent	ouïr	VER:simp
piz	pis	ADV
cuers	coeur	NOM
sauvaigines	sauvagine	NOM
nagaires	naguère	ADV
assamblee	assemblée	NOM
renvahyrent	renvahir	VER:simp
abatirent	abattre	VER:simp
dervees	deruer	VER:pper
esrachierent	arracher	VER:simp
boc	bouc	NOM
martire	martyre	NOM
murdirent	meurtrir	VER:simp
Ha	avoir	VER:pper
por	pour	PRP
saincte	saint	ADJ
soloit	souloir	VER:impf
yssi	issir	VER:pper
plourerent	pleurer	VER:simp
maintes	mainte	ADV
nymphes	Nymphe	NAM
congnoissoient	connaître	VER:impf
desplument	déplumer	VER:pres
fueules	feuille	NOM
foursennees	forcené	ADJ
batus	battre	VER:pper
abatus	abattre	VER:pper
deschirerent	déchirer	VER:simp
batirent	bâtir	VER:simp
dars	dard	NOM
foursennerie	forcenerie	NOM
paistre	paître	VER:infi
buefz	boeuf	NAM
lavoureurs	laboureur	NOM
cultivoient	cultiver	VER:impf
espandre	épandre	VER:infi
semence	sémence	NOM
foles	fou	ADJ
esrageement	esragément	ADV
esmouver	émouvoir	VER:infi
eulx	eux	PRO:PER
enfuyent	enfuir	VER:pres
paoureusement	peureusement	ADV
esparpillerent	éparpiller	VER:simp
pillerent	piller	VER:simp
sauvaigine	sauvagine	NOM
dolurent	douloir	VER:simp
creverent	crever	VER:simp
memebres	membre	NOM
Heber	Hèbre	NAM
resonnoit	résonner	VER:impf
gettoit	jetter	VER:impf
plaingnant	plaindre	VER:ppre
parlans	parler	VER:ppre
flotterent	flotter	VER:simp
erbe	herbe	NOM
crueuse	cruel	ADJ
gisant	gisant	ADJ
sassist	saisir	VER:subp
sus	sus	PRP
baee	béant	ADJ
demourance	demeurance	NOM
chier	chef	NOM
descendy	descendre	VER:pper
vey	voir	VER:simp
embracha	embrasser	VER:simp
asseur	assûr	ADJ
condicion	condition	NOM
Bércynthe	Bercynthe	NAM
naïades	Naïade	NAM
Argo	Argo	NAM
Linos	Linos	NAM
Pimpleia	Pimpleia	NAM
Dion	Dion	NAM
Argonautes	Argonaute	NAM
Sirènes	Sirène	NAM
Mnémosyne	Mnémosyne	NAM
Héraclès	Hercule	NAM
Argonaute	Argonaute	NAM
Colchide	Colchide	NAM
Médée	Médée	NAM
Érinyes	Danaïdes	NAM
Égypte	Égypte	NAM
Hécate	Hécate	NAM
Égine	Égine	NAM
Thèbes	Thèbes	NAM
hydres	Hydre	NAM
Hypnos	Hypnos	NAM
Chiron	Chiron	NAM
Centaure	Centaure	NAM
Cronos	Cronos	NAM
Plouton	Pluton	NAM
lacs	lac	NOM
Hermès	Hermès	NAM
Castor	Castor	NAM
Cythère	Cythère	NAM
Pégase	Pégase	NAM
Minos	Minos	NAM
Heu	heu	INT
Tisiphone	Tisiphone	NAM
Tityos	Tityos	NAM
Anthémoessa	Anthémoessa	NAM
Ligeïa	Ligeïa	NAM
Déméter	Cérès	NAM
asphodèles	Asphodèle	NAM
Ascalaphe	Ascalaphe	NAM
Héra	Junon	NAM
asphodèle	Asphodèle	NAM
Morte	mort	ADJ
Éleusis	Éleusis	NAM
Cicone	Cicone	NAM
Mars	Mars	NAM
Gêtes	Gêtes	NAM
tâchoit	tâcher	VER:impf
déploroit	déplorer	VER:impf
ac­cords	accord	NOM
parens	parent	NOM
sur­prirent	sur­prendre	VER:simp
habitans	habitant	NOM
marchoit	marcher	VER:impf
subit	subir	VER:simp
savoient	savoir	VER:impf
gémissemens	gémissement	NOM
Scythie	Scythès	NAM
erroit	errer	VER:impf
Tanais	Tanaïs	NAM
disgrace	disgrâce	NOM
dédai­gnées	déda­igner	VER:pper
déchirè­rent	déchirer	VER:simp
flottoit	flotter	VER:impf
serieux	sérieux	NOM
celebre	célèbre	NOM
obseques	obsèques	NOM
meriter	mériter	VER:infi
dépeingne	dépeindre	VER:pres
stile	style	NOM
Autheur	auteur	NOM
bisare	bizarre	ADJ
quelquesfois	quelquefois	ADV
facetieux	facétieux	ADJ
Quoy	quoi	PRP
piece	pièce	NOM
sçai	savoir	VER:pres
connoissans	connaître	VER:ppre
plaist	plaire	VER:simp
recouë	recevoir	VER:pper
yure	jurer	VER:pres
Feste	fête	NOM
nuict	nuit	NOM
grabat	grabat	NOM
sabat	sabbat	NOM
serenade	sérénade	NOM
ancre	encre	NOM
Menestrier	ménétrier	NOM
Donzelle	damoiselle	NOM
vielle	vieux	ADJ
donzelle	damoiselle	NOM
lazard	lézard	NOM
epitalame	épithalame	NOM
epitaphe	épitaphe	NOM
tasté	tâter	VER:pper
blouze	blouse	NOM
reclamé	réclamer	VER:pper
gazoüilé	gazouiller	VER:pper
Becare	bécarre	NOM
Bemol	bémol	NOM
recreative	recréatif	ADJ
fredonnoit	fredonner	VER:impf
chastié	châtier	VER:pper
cerbere	Cerbère	NAM
frontiere	frontière	NOM
malle	malle	NOM
elargie	élargir	VER:pper
croyoit	croire	VER:impf
joüer	jouer	VER:infi
mollesse	mollesse	NOM
repert	reperdre	VER:pres
dône	done	NOM
reprise	reprendre	VER:pper
Lutin	lutin	NOM
poux	pouls	NOM
ny	ni	KON
hapelourde	happelourde	NOM
evade	évader	VER:pres
paroist	paraître	VER:pres
espaissi	épaissir	VER:pper
taston	tâton	NOM
poil	poil	NOM
manton	manton	NOM
averne	Averne	NAM
gaigne	gagner	VER:pres
desastre	désastre	NOM
penaud	pénal	ADJ
vingts	vingt	ADJ
baston	bâton	NOM
Pelerin	pélérin	NOM
escarcelle	escarcelle	NOM
besace	bésace	NOM
effaré	effarer	VER:pper
ahury	ahuri	ADJ
mary	mari	NOM
sanglotte	sangloter	VER:pres
deffunte	défunt	NOM
desorienté	désorienter	VER:pper
quoy	quoi	PRP
*	*	SYM
deffait	défaire	VER:impf
Procris	Procris	NAM
beveuë	bévue	NOM
occit	occire	VER:simp
veuë	vue	NOM
desgoiser	dégoiser	VER:infi
escho	écho	NOM
pleint	plaindre	VER:pres
estourdie	étourdir	VER:pper
glapit	glapir	VER:pres
joüant	jouer	VER:ppre
espousaille	épousaille	NOM
desormais	désormais	ADV
Rolland	Roland	NAM
eschappée	échapper	NOM
espée	épée	NOM
cogne	cogner	VER:pres
martelle	marteler	VER:pres
Arion	Arion	NAM
beigne	baigner	VER:pres
tueroit	tuer	VER:cond
dourderoit	darder	VER:cond
sieur	monsieur	NOM
eschauffe	échauffer	VER:pres
eschaufaison	échauffaison	NOM
demangeaison	démangeaison	NOM
demangent	démanger	VER:pres
eschauffer	échauffer	VER:impf
païs	païs	NOM
esbahis	ébahir	VER:pper
seiche	sec	ADJ
mol	mou	ADJ
bis	bis	ADJ
pié	pied	NOM
fruictage	fruitage	NOM
estant	être	VER:ppre
coton	cotton	ADJ
foye	foie	NOM
poulmon	poumon	NOM
estendu	étendre	VER:pper
estourdis	étourdir	VER:pper
salmigondis	salmigondis	NOM
reliquat	réliquat	NOM
ronfloient	ronfler	VER:impf
yvres	ivre	ADJ
vuider	vider	VER:infi
succer	sucer	VER:infi
destramper	détromper	VER:infi
melancholie	mélancholie	NOM
heurlant	hurler	VER:ppre
maturines	Mathurines	NAM
oubly	oubli	NOM
chably	Chablis	NAM
lipée	lippée	NOM
ennuy	ennui	NON
soûpire	soupir	NOM
déconfit	déconfit	NOM
esbat	ébattre	VER:pres
panse	panse	NOM
fourée	fourée	VER:pper
geresolut	geresolut	NAM
fringotte	fringotter	VER:pres
lut	luth	NOM
trouppe	troupe	NOM
vray	vrai	ADJ
charivary	charivari	NOM
dormant	dormir	VER:ppre
desia	déjà	ADV
trouppeau	troupeau	NOM
SS	SS	ABR
yurone	ivrogne	NOM
dains	daim	NOM
remumesnage	remue-ménage	NOM
berluë	berlue	NOM
apperçoy	appercevoir	VER:pres
soy	soi	PRO:PER
fretiller	frétiller	VER:infi
fredon	frédon	NOM
chatoüiller	chatouiller	VER:infi
voy	voir	VER:pres
haye	haie	NOM
parente	parent	NOM
bruiere	bruyère	NOM
halier	hallier	ADJ
debande	débander	VER:pres
esgayer	égayer	VER:infi
sarabande	sarabande	NOM
enuy	ennui	NOM
griesche	grièche	ADJ
emillent	emmiller	VER:pres
Asne	âne	NOM
estonnée	étonner	VER:pper
broustent	brouter	VER:pres
azinique	asinique	ADJ
esguillon	aiguillon	NOM
asne	âne	NOM
semonneur	semoneur	NOM
feste	fête	NOM
poulins	poulain	NOM
retives	rétif	ADJ
bestail	bétail	NOM
chattes	chat	NOM
gesine	gésine	NOM
verats	verrat	NOM
sequelles	séquelle	NOM
beliers	bélier	NOM
oüailles	ouaille	NOM
genisses	génisse	NOM
conils	connil	NOM
lievres	lièvre	NOM
chevres	chèvre	NOM
chevreuls	chevreuil	NOM
biches	biche	NOM
fans	faon	NOM
elephans	éléphant	NOM
rincerot	rhinocéros	NOM
leopards	léopard	NOM
lyons	lion	NOM
hipogriffes	hippogriffe	NOM
cervolans	cerf-volant	NOM
dragons	dragon	NOM
ailez	ailé	ADJ
pecores	pecore	NOM
alaigres	allègre	ADJ
rous	roux	ADJ
quitent	quitter	VER:pres
pasturages	pâturage	NOM
tintoin	tinton	NOM
argus	Argus	NAM
oüye	ouïe	NOM
aimeroit	aimer	VER:cond
taupe	taupe	NOM
aveuglette	aveugle	ADJ
bestialle	bestial	ADJ
trepigne	trépigner	ADJ
armonie	harmonie	NOM
gaigné	gagner	VER:pper
Aubervilliers	Aubervilliers	NAM
trolle	troller	VER:pres
preste	prêt	ADJ
rolle	rôle	NOM
perdroit	perdre	VER:cond
chein	chein	NOM
sçavant	sçavant	ADJ
leçon	leçon	NOM
friser	friser	VER:infi
escurieux	escurieux	NOM
agilité	agilité	NOM
fretillarde	fretillarde	NOM
accorde	accorder	VER:pres
gaillarde	gaillard|gaillarde	NOM
elephant	elephant	NOM
passent	passer	VER:pres
balourds	balourd	ADJ
legers	léger	NOM
volle	voler	VER:pres
crapaut	crapaud	NOM
lezard	lézard	NOM
grenoüille	grenouille	NOM
tortuë	tortue	NOM
estuy	étui	NOM
evertuë	évertuer	VER:pres
escrire	écrire	VER:infi
virevoustes	virevolte	NOM
giroüettes	girouette	NOM
tournoyemens	tournoiement	NOM
piroüettes	pirouette	NOM
capriolles	capriole	NOM
antrechats	entrechat	NOM
melanges	mélange	NOM
seray	être	VER:futu
recit	récit	NOM
beste	bête	NOM
deffier	défier	VER:infi
lyonne	lion	NOM
lyon	lion	NOM
baler	baller	VER:infi
dançant	dancer	VER:ppre
enqueste	enquête	NOM
escole	école	NOM
aprivoise	apprivoiser	VER:pres
bale	baller	VER:pres
difference	différence	NOM
pagnottes	pagnote	NOM
fievreux	fiévreux	ADJ
joye	joie	NOM
passeroient	passer	VER:condi
delicats	délicat	ADJ
piege	piège	NOM
raiseaux	réseau	NOM
estourneau	étourneau	NOM
espervier	épervier	NOM
oye	oie	NOM
guillery	guilleri	NOM
chauve-soury	chauve-souris	NOM
orfraye	orfriye	NOM
avecque	avec	PRP
aloüette	alouette	NOM
choüette	chouette	NOM
joly	joli	ADJ
guay	gai	ADJ
sangluer	sangluer	VER:infi
Oyseaux	oiseau	NOM
trebuchet	trébuchet	NOM
reverence	révérence	NOM
gay	gai	ADJ
ceremonie	cérémonie	NOM
oüyr	ouïr	NOM
serin	serin	NOM
cigalle	cigale	NOM
fix	fixe	ADJ
gril	grille	NOM
sçeu	savoir	VER:pper
depercher	dépercher	VER:infi
demy	demi	ADV
roty	rôtir	VER:pper
bucher	bûcher	NOM
oyseau	oiseau	NOM
Arcadie	Arcadie	NAM
discretion	discrétion	NOM
asnesse	ânesse	NOM
tenteroit	tenter	VER:condi
Roy	roi	NOM
ravy	ravi	ADJ
champestre	champêtre	ADJ
prefere	préférer	VER:pres
messire	monsieur	NOM
oyroit	ouïr	VER:condi
riroit	rire	VER:condi
chastiment	châtiment	NOM
suivy	suivre	VER:pper
mesnage	ménage	NOM
quarties	quartier	NOM
nommerois	nommer	VER:condi
Mandosse	Mandosse	NAM
pitaux	piteux	NOM
espousée	épouse	NOM
menoient	mener	VER:impf
mettoit	mettre	VER:impf
estame	estame	NOM
entraisne	entraîner	VER:pres
saults	saut	NOM
cullebutes	culbute	NOM
butords	butor	NOM
torts	tordu	ADJ
cabriolle	cabriole	NOM
frisée	frisé	ADJ
employ	emploi	NOM
nostres	notre	DET:POS
lourdise	lourdise	NOM
redresse	redresser	VER:pres
Vulcain	Vulcain	NAM
silene	Silène	NAM
gouteux	goûteux	ADJ
bequille	béquille	NOM
potence	potence	NOM
feroient	faire	VER:condi
tortu	tordu	ADJ
diroit	dire	VER:condi
bandir	bandir	VER:infi
feroit	faire	VER:condi
cagatte	cagate	NOM
dança	danser	VER:simp
jambe	jambe	NOM
dancent	danser	VER:pres
Vacher	vacher	NOM
cor	cor	NOM
dancé	danser	VER:pper
recompensé	récompenser	VER:pper
foutu	foutu	ADJ
top	top	ADJ
Ben	ben	INT
répèt	répétition	NOM
Pan	Pan	NAM
Ovide	Ovide	NAM
nymphe	Nymphe	NAM
Jason	Jason	NAM
Malibu	Malibu	NAM
Aspivenin	Aspivenin	NAM
haaaa	ha	INT
Hébre	Hébre	NAM
Erébe	Érèbe	NAM
sifflemens	sifflement	NOM
aboyemens	aboiement	NOM
palpitans	palpitant	ADJ
chan­tait	chan­ter	VER:impf
reten­tit	reten­tir	VER:simp
dis­paraît	dis­paraître	VER:pres
re­disait	re­dire	VER:impf
Hymenee	Hyménée	NAM
safranee	safrané	ADJ
Ciconin	Ciconien	NAM
esperoit	espérer	VER:impf
benin	bénin	NOM
fumoient	fumer	VER:impf
petilloient	pétiller	VER:impf
distiloient	distiler	VER:impf
branlans	branler	VER:ppre
fâcheux	fâcheux	ADJ
Najades	Naïade	NAM
égayans	égayer	VER:ppre
nopce	noce	NOM
vid	voir	VER:pper
trépassee	trépassé	ADJ
blessee	blessé	ADJ
Rodope	Rhodope	NAM
Tenarien	Ténarien	NAM
Manes	Mânes	NAM
Persephone	Perséphone	NAM
fantaumes	fantôme	NOM
plaisans	plaisant	ADJ
Lut	luth	NOM
mesle	mêler	VER:pres
acords	accord	NOM
soûterrains	souterrain	ADJ
blesme	blême	NOM
étoufer	étouffer	VER:infi
permetez	permettre	VER:pres
devalé	dévaler	VER:pper
Meduse	Méduse	NAM
veneneux	venimeux	ADJ
acourcy	accourcir	VER:pper
cognoissent	connaître	VER:pres
cognoissez	connaître	VER:pres
domte	dompter	VER:pres
creinte	crainte	NOM
Cahos	chaos	NOM
rapellez	rappeler	VER:pres
meuri	mûrir	VER:pper
éforts	effort	NOM
accors	accord	NOM
soûpiroient	soupirer	VER:impf
tantale	Tantale	NAM
oublioit	oublier	VER:impf
roüet	rouet	NOM
arrestoit	arrêter	VER:impf
voyoit	voir	VER:impf
Eumenides	Euménides	NAM
éconduirent	éconduire	VER:simp
promte	prompt	ADJ
hucherent	hucher	VER:simp
Rodopeïen	Rhodopien	NAM
iroit	aller	VER:cond
Orque	Orque	NAM
afranchi	affranchir	VER:pper
barriere	barrière	NOM
panchant	pencher	VER:ppre
épaix	épais	ADJ
touchoient	toucher	VER:impf
recheute	rechute	NOM
disparuë	disparu	ADJ
éforcé	efforcé	ADJ
ambrasser	embrasser	VER:infi
ambrassé	embrasser	VER:pper
atrape	attraper	VER:pres
cede	céder	VER:pres
échape	échapper	VER:pres
euridice	Eurydice	NAM
requite	requitter	VER:pres
formee	former	VER:pper
aymee	aimer	VER:pper
aperceut	apercevoir	VER:simp
plutost	plutôt	NOM
transportee	transporter	VER:pper
adorois	adorer	VER:impf
Lethee	Léthé	NAM
estes	être	VER:pres
Ide	Ida	NAM
joignant	joindre	VER:ppre
étendoit	étendre	VER:impf
répandoit	répandre	VER:impf
coline	colline	NOM
glan	gland	NOM
Caonien	caonien	ADJ
Heliades	Héliades	NAM
escule	escule	NOM
paroissant	paraître	VER:ppre
teils	tilleul	NOM
molet	mollet	NOM
fouteaux	hêtre	NOM
fresne	frêne	NOM
noüé	nouer	VER:pper
panchantes	penchant	ADJ
plane	platane	NOM
saussaye	saule	NOM
ayme	aimer	ADJ
lote	lotos	NOM
bruyere	bruyère	NOM
bluastre	bluâtre	ADJ
ployable	pliable	ADJ
pampree	pampré	ADJ
pignole	pignon	NOM
arbosier	arbousier	NOM
ployant	ployer	VER:ppre
vinqueurs	vainqueur	NOM
herissé	hérisser	VER:pper
agreable	agréable	ADJ
dautant	d'autant	ADV
prestre	prêtre	NOM
Avecque	avec	PRP
Cypres	cyprès	NOM
gent	gent	NOM
Thracienne	thracien	ADJ
tiroit	tirer	VER:impf
oyantes	oyant	ADJ
voicy	voici	ADV
feminin	féminin	ADJ
échaufee	échauffé	ADJ
aperceurent	apercevoir	VER:simp
felon	félon	NOM
ateinte	atteinte	NOM
sedition	sédition	NOM
éfaits	éfait	NOM
amolis	amolir	VER:pper
éclatans	éclatant	ADJ
exorbitans	exorbitant	ADJ
batemens	battement	NOM
étoufoient	étouffer	VER:impf
caillous	caillou	NOM
entendans	entendant	ADJ
encores	encore	ADV
theatre	théâtre	NOM
Menades	Ménade	NAM
tournans	tourner	VER:ppre
sanglans	sanglant	ADJ
amasserent	amasser	VER:simp
cheins	cheins	NOM
areine	arène	NOM
meine	mener	VER:pres
amphiteatre	amphithéâtre	NOM
thirses	thyrse	NOM
jettoient	jeter	VER:impf
labourast	labourer	VER:subi
béchast	bêcher	VER:subi
suans	suer	VER:ppres
charuës	charrue	NOM
arachent	arracher	VER:pres
éfort	effort	NOM
foibles	faible	ADJ
reclamant	réclamer	VER:ppre
bourelles	bourelle	NOM
ha	ha	INT
entenduë	entendre	VER:pper
dépoüillans	dépouiller	VER:ppre
enflees	enfler	VER:pper
Nymfes	Nymphe	NAM
échevelees	écheveler	VER:pper
recognuës	reconnaître	VER:pper
veuës	voir	VER:pper
côte	côte	NOM
menent	mener	VER:pres
châque	chaque	ADJ
asseurément	assurément	ADV
croupissante	croupissant	ADJ
Rhiphées	Rhiphées	NAM
mesdames	madame	NOM
Jenny	Jenny	NAM
Memphis	Memphis	NAM
Paris	Paris	NAM
Cyrène	Cyrène	NAM
Canope	Canope	NAM
malaise	malaise	NOM
apelle	appeler	VER:pres
Nil	Nil	NAM
Acherusia	Acherusia	NAM
Isis	Isis	NAM
Gorgones	Gorgone	NAM
anubis	Anubis	NAM
Prométhée	Prométhée	NAM
Furie	Danaïde	NAM
Aloëus	Aloée	NAM
Salmonée	Salmonée	NAM
poëtes	poète	NOM
Léthé	Léthé	NAM
Cyceon	Cycéon	NAM
Mnemosyne	Mnémosyne	NAM
criptes	crypte	NOM
Pline	Pline	NAM
Apis	Apis	NAM
Bubaste	Bubaste	NAM
Alceste	Alceste	NAM
Thésée	Thésée	NAM
Horus	Horus	NAM
Saturne	Cronos	NAM
Osiris	Osiris	NAM
Typhon	Typhon	NAM
Phtha	Phtha	NAM
Neith	Neith	NAM
Cnuph	Cnuph	NAM
Amenthès	Amenthès	NAM
Élysée	Élysée	NAM
Rursus	Rursus	SYM
corpora	corpora	SYM
velle	velle	SYM
reverti	reverti	SYM
Cérés	Cérès	NAM
Éleusine	Éleusine	NAM
Chloris	Chloris	NAM
Daphné	Daphné	NAM
Cythéréa	Cythère	NAM
Erôs	Éros	NAM
Anacréon	Anacréon	NAM
Théos	Théos	NAM
Schio	Schio	NAM
Athènes	Athènes	NAM
Corinthe	Corinthe	NAM
Crête	Crète	NAM
Euripide	Eurypide	NAM
Horace	Horace	NAM
Tusculum	Tusculum	NAM
Pyrrha	Pyrrha	NAM
Lydie	Lydie	NAM
Téléphe	Téléphe	NAM
Glycère	Glycère	NAM
Chloé	Chloé	NAM
Myrtale	Myrtale	NAM
Lycoris	Lycoris	NAM
Cyrus	Cyrus	NAM
Barine	Barine	NAM
Tibre	Tibre	NAM
Lydé	Lydé	NAM
Flaccus	Flaccus	NOM
Mercure	Hermès	NAM
Néobule	Néobule	NAM
Hébrus	Hèbre	NAM
Galatée	Galatée	NAM
Phryné	Phryné	NAM
nec	nec	SYM
uno	uno	SYM
Phryne	Phryné	NAM
macerat	macerat	SYM
Mécène	mécène	SYM
Néère	Néère	NAM
Anio	Anio	NAM
Phylis	Phylis	NAM
Albe	Albe	NAM
Tibur	Tibur	NAM
Cinara	Cinara	NAM
Corinne	Corinne	NAM
Auguste	Auguste	NAM
Rome	Rome	NAM
Italie	Italie	NAM
Lesbie	Lesbie	NAM
Catulle	Catulle	NAM
Lesbius	Lesbius	NAM
Quintius	Quintius	NAM
Gellius	Gellius	NAM
Tibulle	Tibulle	NAM
Némésis	Némésis	NAM
Sulpicia	Sulpicia	NAM
Tyr	Tyr	NAM
crudele	crudele	SYM
genus	genus	SYM
rebuts	rebuts	SYM
Properce	Properce	NAM
Gallus	Gallus	NAM
Cynthia	Cynthia	NAM
Cythéris	Cythéris	NAM
Catilina	Catilina	NAM
Anacréaon	Anacréon	NAM
Polycrate	Polycrate	NAM
Ève	Ève	NAM
Heros	héros	NOM
façent	faire	VER:subp
Comedie	comédie	NOM
publicq	public	NOM
graces	grâce	NOM
genereux	généreux	ADJ
fidelle	fidèle	ADJ
Scene	scène	NOM
Françoise	français	ADJ
parroistre	paraître	VER:infi
Decembre	décembre	NOM
cognoistre	connaître	VER:infi
siecles	siècle	NOM
presens	présent	ADJ
necessaire	nécéssaire	ADJ
parfaicte	parfait	ADJ
miraculeur	miraculeux	ADJ
decorations	décoration	NOM
Comediens	comédien	NOM
Marests	Marais	NAM
Theatre	théâtre	NOM
Driades	Dryades	NAM
Bachantes	Bacchante	NAM
Forests	forêts	NOM
Deserts	désert	NOM
agreablement	agréablement	ADV
thoille	toile	NOM
esclair	éclair	NOM
eslevation	élevation	NOM
esloignement	éloignement	NOM
estans	être	VER:ppre
representez	représenter	VER:pres
regions	région	NOM
inferieures	inférieur	ADJ
Junon	Junon	NAM
espoisseur	épaisseur	NOM
parroistra	paraître	VER:futu
lumieres	lumière	NOM
Tonneres	tonnère	NOM
Esclairs	éclair	NOM
Tempestes	tempête	NOM
troubloit	troubler	VER:impf
Elements	élément	NOM
Meteores	Météores	NAM
aysé	aisé	ADJ
Nopces	noce	NOM
Estant	être	VER:ppre
descenduë	descendre	VER:pper
esgalement	également	ADV
Diane	Diane	NAM
Bachus	Bacchus	NAM
Caliste	Caliste	NAM
resout	résoudre	VER:pres
declarer	déclarer	VER:infi
colere	colère	NOM
obeyssance	obéissance	NOM
branslé	branler	VER:pper
escoute	écouter	VER:pres
siflemens	siflement	NOM
necessaires	nécéssaire	ADJ
desrober	dérober	VER:infi
jouyssance	jouissance	NOM
executer	exécuter	VER:infi
commandemens	commandement	NOM
jettant	jeter	VER:ppre
hayne	haine	NOM
desesperé	désespéré	ADJ
mespris	mépris	NOM
resoult	résoudre	VER:simp
Demons	démon	NOM
pourroient	pouvoir	VER:impf
flater	flâter	VER:infi
succéz	succès	NOM
suggere	suggérer	VER:pres
tirannisoient	tiranniser	VER:impf
Eurimedon	Eurymédon	NAM
bastiment	bâtiment	NOM
demeur	demeure	NOM
aprend	apprendre	VER:pres
conference	conférence	NOM
Colomnes	colonne	NOM
desmolis	démolir	VER:pper
invoquation	invocation	NOM
exalé	exhaler	VER:pper
abstratifs	abstrait	ADJ
recognoistre	reconnaître	ADJ
espargné	épargner	VER:pper
credit	crédit	NOM
respandre	répandre	VER:infi
disgraces	disgrâce	NOM
asseurance	assurance	NOM
espouvantables	épouvantable	ADJ
different	différent	ADJ
precedente	précédent	ADJ
Decoration	décoration	NOM
haulteur	hauteur	NOM
Pallissades	palissade	NOM
estenduë	étendre	VER:pper
Fruicts	fruit	NOM
Hyver	hiver	NOM
esgayées	égayer	VER:pper
morellement	moralement	ADV
picquée	piquer	VER:pper
plustost	plutôt	ADV
estonnement	étonnement	NOM
Requeste	requête	NOM
reagir	réagir	VER:infi
horison	horizon	NOM
troisiéme	troisième	ADJ
parroist	paraître	VER:simp
traisné	traîner	VER:pper
Piroys	Pyroeis	NAM
Eous	Erythreus	NAM
Phlegon	Phlegon	NAM
romflent	ronfler	VER:pres
esclaire	éclairer	VER:pres
aprochant	approcher	VER:pres
Apres	après	ADV
remply	remplir	VER:pper
infiny	infini	ADJ
Perspective	perspective	NOM
mineraux	minéral	NOM
metaux	métal	NOM
advoüer	avouer	VER:infi
ydée	idée	NOM
Cét	ce	PRO:DEM
expres	exprès	ADJ
reflections	refléxion	NOM
perçans	perçant	ADJ
apris	apprendre	VER:pper
falloit	falloir	VER:impf
Infernalles	infernal	ADJ
sçachant	savoir	VER:ppre
Thenare	Ténare	NAM
tanter	tenter	VER:infi
Cocite	Cocyte	NAM
sepulture	sépulture	NOM
foelicitez	féliciter	VER:pres
infernalles	infernal	ADJ
contrainct	contraindre	VER:simp
Nautonnier	nautonier	NOM
parroissoit	paraître	VER:impf
Tenebres	ténèbre	NOM
Decorations	décoration	NOM
troisieme	troisième	ADJ
espouvantable	épouvantable	ADJ
Icy	ici	ADV
reflexion	réflexion	NOM
tascher	tâcher	VER:infi
descrire	décrire	VER:pper
sçauroient	savoir	VER:impf
disparroissant	disparaître	VER:pres
genie	génie	NOM
esloignemens	éloignement	NOM
diversitez	diversité	NOM
representoit	représenter	VER:impf
meslange	mélange	NOM
estonans	étonnant	ADJ
espreuve	épreuve	NOM
parroissant	paraître	VER:ppre
prest	prêt	ADJ
adoroit	adorer	VER:impf
eslargy	élargi	ADJ
maistrisans	maîtriser	VER:ppre
forcerent	forcer	VER:simp
traisnée	trainer	VER:pper
blesmis	blêmir	VER:pper
nuicts	nuit	NOM
eternelles	éternel	ADJ
Aussy	aussi	ADV
recognoist	reconnaître	VER:simp
exceds	excès	NOM
escouter	écouter	VER:infi
resolutions	résolution	NOM
estonnantes	étonnant	ADJ
meslez	mêler	VER:pres
quatriéme	quatrième	ADJ
Rodoppe	Rhodope	NAM
tesmoins	témoin	NOM
trespas	trépas	NOM
esoit	être	VER:impf
Alphée	Alphée	NAM
Decorateur	décorateur	NOM
mespriser	mépriser	VER:infi
esprises	éprendre	VER:pper
croyans	croire	NOM
pardant	perdre	VER:ppre
Anthousiasme	enthousiasme	NOM
attaquerent	attaquer	VER:simp
demeurans	demeurer	VER:ppre
perdoient	perdre	VER:impf
abaissans	abaisser	VER:ppre
sembloient	sembler	VER:impf
advantage	avantage	NOM
redoublans	redoubler	VER:ppre
creatures	créature	NOM
deschirent	déchirer	VER:pre
aymable	aimable	ADJ
attendoit	attendre	VER:impf
fidel	fidèle	ADJ
aprenant	apprendre	VER:ppre
Mesnades	Ménade	NAM
Silene	Silène	NAM
lascitude	lassitude	NOM
Phrigie	Phrygie	NAM
rappeller	rappeler	VER:infi
memoire	mémoire	NOM
Buffequin	Buffequin	NAM
nouveautez	nouveauté	NOM
renfrognée	renfrogner	VER:pper
Ç'	ça	PRO:DEM
presqu'	presque	ADV
peignent	peindre	VER:pre
Moires	Parque	NAM
Moire	Parque	NAM
Épire	Épire	NAM
Libéthra	Libéthra	NAM
Tocatta	tocatta	NOM
Ritournelle	ritournelle	NOM
Permesso	permesso	NOM
Pinde	Pinde	NAM
Hélicon	Hélicon	NAM
Parnasse	Parnasse	NAM
Saba	Saba	NAM
Sylvia	Sylvia	NAM
Nymphe	Nymphe	NAM
Écho	Écho	NAM
Argus	Argus	NAM
Ritornelle	ritournelle	NOM
brulant	brûler	VER:ppre
sécouât	secouer	VER:subi
évenement	événement	NOM
addressa	adresser	VER:simp
precipitez	précipiter	VER:pper
assés	assez	ADV
neanmoins	néanmoins	ADV
connoit	connaître	VER:pres
ajoûter	ajouter	VER:infi
foy	foi	NOM
enlevement	enlèvement	NOM
étenduë	étendue	NOM
siécles	siècle	NOM
auprés	auprès	ADV
alteré	altérer	VER:pper
roüe	roue	NOM
pûrent	pouvoir	VER:simp
demandoit	demander	VER:impf
appellée	appellée	VER:pper
lents	lent	ADJ
reçût	recevoir	VER:subi
regarderoit	regarderer	VER:impf
régnent	régnent	VER:subp
alloient	aller	VER:impf
disparût	disparaître	VER:subi
mourût	mourir	VER:subi
replongea	replonger	VER:simp
conjura	conjurer	VER:simp
flechir	flechir	NOM
Hemus	Hemus	NAM
joüet	joüet	NOM
passerent	passer	VER:simp
propositions	proposition	NOM
himen	himen	NOM
regrettât	regretter	VER:subi
souhaiterent	souhaiter	VER:simp
rejettées	rejettées	VER:pper
excita	exciter	VER:simp
joüé	joüé	VER:pper
agrémens	agrémens	NOM
erable	erable	ADJ
figues	figue	NOM
violetes	violetes	ADJ
planter	planter	VER:infi
rempant	rempant	ADJ
entrelassé	entrelassé	VER:pper
septs	septs	NOM
resine	resine	NOM
allerent	aller	VER:simp
revetuës	revetuës	NOM
estomach	estomach	NOM
apperçûrent	apperçûrent	VER:simp
flottans	flottans	NOM
entortillé	entortiller	VER:pper
attenter	attenter	VER:infi
empottées	empottées	NOM
redoublerent	redoubler	VER:simp
Neanmoins	Neanmoins	NOM
amolli	amollir	VER:pper
employoit	employer	VER:impf
flutes	flutes	NOM
recontrent	recontrent	VER:simp
arene	arene	NOM
acharnées	acharner	VER:pper
tyrses	tyrses	NOM
mechanceté	mechanceté	NOM
ramassent	ramasser	VER:pres
accablent	accabler	VER:pres
detellé	detellé	VER:pper
terminer	terminer	VER:infi
inhumaines	inhumain	ADJ
accablez	accabler	VER:pres
depoüillez	depoüillez	VER:pres
habillerent	habiller	VER:simp
échevelées	échevelé	ADJ
dechiré	dechiré	NOM
pieces	pieces	NOM
dispersé	disperser	VER:pper
hebre	hebre	NOM
inanimé	inanimé	ADJ
retentissoient	retentisser	VER:impf
lecha	lecha	NOM
découloit	découler	VER:impf
transforma	transformer	VER:simp
beante	beante	ADJ
trouvée	trouver	VER:pper
aprehender	aprehender	NOM
justement	justement	ADV
irrité	irriter	VER:pper
comparée	comparer	VER:pper
écouté	écouter	VER:pper
dard	dard	NOM
homicide	homicide	ADJ
fidèles	fidèle	ADJ
gêtes	gêtes	NOM
guerriers	guerrier	NOM
Orythie	Orythie	NAM
mêlèrent	mêler	VER:simp
affrontant	affronter	VER:ppre
affreuses	affreux	ADJ
impassible	impassible	ADJ
sourds	sourd	ADJ
inanimés	inanimé	ADJ
enfermés	enfermer	VER:pper
homicides	homicide	ADJ
hérisser	hérisser	VER:infi
clémente	clément	ADJ
ixion	ixion	NOM
suspendit	suspendre	VER:simp
indulgence	indulgence	NOM
humbles	humble	ADJ
paupière	paupière	NOM
portât	porter	VER:subi
emportait	emporter	VER:impf
déplora	déplorer	VER:simp
nids	nid	NOM
envoie	envoyer	VER:pres
Borée	borée	NOM
complice	complice	ADJ
accusait	accuser	VER:impf
Murmurait	murmurer	VER:impf
appas	appas	NOM
Reconnois	Reconnois	NAM
vengeur	vengeur	ADJ
surpasse	surpasser	VER:pres
attachée	attacher	VER:pper
causas	causer	VER:simp
priva	priver	VER:simp
forfaits	forfait	NOM
mesuré	mesurer	VER:pper
inhumains	inhumain	ADJ
Getes	Getes	NAM
pénétrées	pénétrer	VER:pper
mêla	mêler	VER:simp
traînois	traînois	VER:subi
inspirant	inspirer	VER:ppre
soupirer	soupirer	VER:infi
Onde	onde	NOM
Astres	astre	NOM
Cieux	cieux	NOM
dévoré	dévorer	VER:pper
causent	causer	VER:pres
affronte	affronter	VER:pres
errans	errans	ADJ
déchaînés	déchaîner	VER:pper
éclairs	éclair	NOM
Élisiens	Élisiens	ADJ
riantes	riant	ADJ
épouses	épouse	NOM
chéries	chérir	VER:pper
fidéle	fidéle	VER:subp
Bellone	Bellone	NAM
généreuses	généreux	ADJ
Princes	prince	NOM
printems	printems	NOM
adorées	adorer	VER:pper
baignent	baigner	VER:pres
limoneux	limoneux	ADJ
remparts	rempart	NOM
barriére	barriére	NOM
lumiére	lumiére	NOM
manes	manes	NOM
Thisiphone	Thisiphone	NAM
heurlemens	heurlemens	NOM
ravissemens	ravissemens	NOM
ramenant	ramener	VER:ppre
conquête	conquête	NOM
éxcès	éxcès	NOM
soupirant	soupirer	VER:ppre
lé­gère	lé­gère	ADJ
Mégére	Mégére	NAM
subis	subir	VER:simp
rigoureuse	rigoureux	ADJ
inhumaine	inhumain	ADJ
voute	voute	NOM
ébranla	ébranler	VER:simp
recula	reculer	VER:simp
r'ouvre	r'ouvre	VER:pres
espére	espére	VER:pres
paupiére	paupiére	NOM
disparoît	disparoît	VER:pres
éxiler	éxiler	VER:infi
déja	déja	NOM
atten­drie	atten­drie	NOM
Nautonier	nautonier	NOM
inéxorable	inéxorable	ADJ
livrée	livrer	VER:pper
accouru	accourir	VER:pper
déséspoir	déséspoir	NOM
parcourant	parcourir	VER:ppre
inhabitée	inhabité	ADJ
repeter	repeter	VER:infi
Tigres	tigre	NOM
Ours	ours	NOM
suspend	suspendre	VER:pres
paroissent	paroissent	VER:pres
Philoméle	Philoméle	NAM
aîle	aîle	NOM
exhalent	exhaler	VER:pres
allarmes	allarmes	NOM
climats	climat	NOM
Scithie	Scithie	NAM
Orithie	Orithie	NAM
baigné	baigner	VER:pper
irritant	irriter	VER:ppre
consacrés	consacrer	VER:pper
mystiques	mystique	ADJ
yvresses	yvresses	NOM
souléve	souléve	VER:pres
Prêtresses	prêtresse	NOM
armant	armer	VER:ppre
redouté	redouter	VER:pper
excité	excité	ADJ
ensanglanté	ensanglanter	VER:pper
répéte	répéte	NOM
Thétis	Thétis	NAM
attendrisse	attendrir	VER:subp
oÿ	oÿ	NOM
jouvencel	jouvencel	NOM
espousa	espousa	VER:simp
Yentà	Yentà	NOM
/	/	PUN
eur	eur	NOM
nuz	nuz	NOM
fuytte	fuytte	NOM
Eridice	Eridice	NOM
plouré	plouré	ADJ
herpe	herpe	NOM
chançon	chançon	NOM
regnans	regnans	NOM
charte	charte	NOM
tenans	tenans	ADJ
submise	submise	NOM
essaier	essaier	NOM
crudelité	crudelité	NOM
gouvernement	gouvernement	NOM
transporté	transporter	VER:pper
erudice	erudice	NOM
courroussa	courroussa	VER:simp
el	el	ADJ
esbahi	esbahi	VER:pper
lay	lay	NOM
Yxion	Yxion	NOM
delez	delez	VER:pres
Sisifus	Sisifus	NAM
renommee	renommee	NOM
acroire	acroire	NOM
Eumenidiennes	Eumenidiennes	NOM
pluroient	plurer	VER:impf
oncques	oncques	ADV
avenu	avenu	ADJ
pouoit	pouer	VER:impf
lermoyer	lermoyer	VER:infi
joieux	joieux	ADJ
suivroit	suivrer	VER:impf
ysteroit	ysterer	VER:impf
forvoiable	forvoiable	ADJ
esvanoÿst	esvanoÿst	VER:subi
amy	amy	NOM
menger	menger	NOM
prins	prin	NOM
nonobstant	nonobstant	PRP
pou	pou	NOM
jouÿr	jouÿr	VER:subi
oÿr	oÿr	NOM
aprint	aprint	NOM
fiançailles	fiançailles	NOM
cure	cure	NOM
fouyt	fouyt	VER:subi
jouvenceaulx	jouvenceaulx	NOM
masles	masles	ADJ
desquelz	desquelz	NOM
orrez	orrez	VER:futu
cy	cy	ADJ
epres	epres	NOM
ystoire	ystoire	NOM
povons	povons	VER:pres
droitement	droitement	ADV
entendement	entendement	NOM
umain	umain	NOM
lignaige	lignaige	NOM
ensenble	ensenble	ADJ
joinctes	joinctes	ADJ
prenons	prendre	VER:pres
contree	contree	NOM
eslonge	eslonge	VER:pres
adonc	adonc	ADV
malices	malice	NOM
terriennes	terrien	ADJ
abuse	abuser	VER:pres
folement	folement	NOM
contentement	contentement	NOM
treuve	treuve	NOM
nud	nud	NOM
descouvert	descouvert	VER:pper
consciene	consciene	NOM
perverse	pervers	ADJ
inique	inique	ADJ
nonchaloir	nonchaloir	NOM
verus	verus	ADJ
vobis	vobis	NOM
dictis	dictis	NOM
malum	malum	NOM
bonum	bonum	NOM
Maudis	maudire	VER:pres
dient	dient	NOM
Stix	Stix	NAM
tresmauvais	tresmauvais	VER:impf
tresabhominable	tresabhominable	ADJ
mesmes	mesmes	NOM
tiers	tiers	NOM
povre	povre	NOM
parfont	parfaire	VER:pres
undes	undes	NOM
telement	telement	NOM
oste	oste	ADJ
mortele	mortele	ADJ
desesperance	desesperance	NOM
propriete	propriete	ADJ
doloureuse	doloureuse	ADJ
lermes	lermes	NOM
quint	quint	NOM
nonrage	nonrage	NOM
ordure	ordure	NOM
adventure	adventure	NOM
dedens	dedens	NOM
convoitise	convoitise	NOM
beuvree	beuvree	NOM
tourmentee	tourmentee	NOM
perdicion	perdicion	NOM
livree	livree	NOM
eaue	eaue	NOM
fain	fain	NOM
ardante	ardante	ADJ
couvoitise	couvoitise	NOM
regorger	regorger	VER:infi
osent	oser	VER:pres
aiser	aiser	VER:infi
ainse	ainse	ADJ
penent	penent	VER:pres
amasser	amasser	VER:infi
acquerre	acquerre	NAM
Iziphus	Iziphus	NOM
trebusche	trebusche	NOM
socieuse	socieuse	ADJ
tirans	tirans	NOM
seigneurs	seigneur	NOM
mondain	mondain	ADJ
montez	monter	VER:pres
menu	menu	ADJ
ataignent	ataignent	VER:pres
cheent	cheent	VER:pres
trebuschent	trebuschent	VER:subp
espee	espee	NOM
deshonneste	deshonneste	ADJ
quises	quises	NOM
delassent	delassent	VER:subi
vitupere	vitupere	NOM
tournoiemens	tournoiemens	NOM
noter	noter	VER:infi
peché	peché	NOM
arester	arester	NOM
conduist	conduist	NOM
maine	maine	ADJ
Laquele	Laquele	ADJ
pouvons	pouvoir	VER:pres
remors	remors	NOM
tusjours	tusjours	NOM
aguillone	aguillone	NOM
couvres	couvrir	VER:pres
desquelles	duquel	PRO:REL
redarguer	redarguer	VER:infi
estuiver	estuiver	NOM
solicitude	solicitude	NOM
pecheur	pecheur	NOM
aucunement	aucunement	ADV
ronge	ronger	VER:pres
Mieulx	Mieulx	NAM
vault	vault	VER:futu
delaisser	delaisser	VER:infi
cuident	cuider	VER:pres
notent	noter	VER:pres
signifient	signifier	VER:pres
gloutons	glouton	NOM
jor	jor	NOM
engloutir	engloutir	VER:infi
vins	vin	NOM
delicatives	delicatives	ADJ
exquises	exquis	ADJ
gourmander	gourmander	VER:infi
indigens	indigens	NOM
cuidans	cuidans	VER:impf
saouler	saouler	VER:infi
ventres	ventre	NOM
touteffois	touteffois	NOM
familleux	familleux	ADJ
Vitupere	Vitupere	NAM
damnacion	damnacion	NOM
eternelle	eternelle	ADJ
ensuivent	ensuivre	VER:pres
omme	omme	NOM
abrege	abrege	VER:pres
aves	ave	NOM
fouit	fouir	VER:pres
enlaidit	enlaidir	VER:pres
terte	terte	NOM
raisonner	raisonner	VER:infi
atouchement	atouchement	NOM
oirent	oirent	VER:simp
fruis	fruis	VER:pres
neffliers	neffliers	NOM
cipres	cipres	NOM
cerisiers	cerisier	NOM
athin	athin	NOM
mue	mouvoir	VER:pper
Cipres	Cipres	NOM
plumaiges	plumaiges	NOM
accordees	accordees	NOM
precedent	precedent	ADJ
sauvaigels	sauvaigels	NOM
areable	areable	ADJ
Ciconie	Ciconie	NAM
raigne	raigne	NOM
doctrient	doctrient	NOM
crierent	crier	VER:simp
traitre	traitre	NOM
homes	home	NOM
deshonnourees	deshonnourees	NOM
confondues	confondre	VER:pper
lanca	lanca	VER:simp
blesça	blesça	VER:simp
hante	hanter	VER:pres
cheit	cheit	NOM
forsennerie	forsennerie	NOM
desverie	desverie	NOM
yre	yre	NOM
veirent	veirent	VER:simp
bussines	bussines	NOM
amoindir	amoindir	VER:infi
Affin	affin	ADJ
rongierent	rongier	VER:simp
desvoieez	desvoieez	NOM
gierement	gierement	NOM
deist	deist	NOM
ad	ad	ADV
pitie	pitie	NOM
Ain	Ain	VER:cond
meurdirent	meurdirent	VER:simp
souloit	souler	VER:impf
enchante	enchanter	VER:pres
plumez	plumer	VER:pres
pareillement	pareillement	ADV
descirerent	descirer	VER:simp
mieulx	mieulx	NOM
forennerie	forennerie	NOM
Pres	Pres	VER:pper
beufz	beufz	NOM
aroient	arer	VER:impf
pensans	pensans	ADJ
coutre	coutre	NOM
aixeul	aixeul	NOM
ravirent	ravir	VER:simp
sauvagine	sauvagine	NOM
secherent	secher	VER:simp
raisonnerent	raisonner	VER:simp
hayé	hayé	VER:pper
demourence	demourence	NOM
vilz	vilz	NOM
embraça	embraça	VER:simp
asseur	asseur	ADJ
volant	voler	VER:ppre
semonce	semonce	NOM
Ris	ris	NOM
Jeux	jeu	NOM
flame	flame	NOM
petille	petille	NOM
innocens	innocens	NOM
gemit	gemit	VER:simp
tal	tal	ADJ
excés	excés	NOM
environner	environner	VER:infi
penetre	penetre	VER:subp
Grandeur	grandeur	NOM
soûtenant	soûtenant	VER:ppre
concerts	concert	NOM
daignez	daigner	VER:pres
prester	prester	NOM
voys	voys	VER:subi
soufferte	souffrir	VER:pper
États	États	NAM
sçairoit	sçairer	VER:impf
couvrit	couvrir	VER:simp
assemble	assembler	VER:pres
noirastres	noirastres	ADJ
abbreuvé	abbreuvé	ADJ
flechisse	flechisse	VER:subp
Vostre	Vostre	NAM
étendre	étendre	VER:infi
dégoust	dégoust	NOM
Sujette	sujet	NOM
supréme	supréme	ADJ
verrez	voir	VER:futu
veylent	veylent	VER:subp
inexorables	inexorable	ADJ
Auprés	Auprés	VER:pper
Gardez	garder	VER:pres
gardez	garder	VER:pres
touchans	touchans	NOM
trouvent	trouver	VER:pres
Surpris	surprendre	VER:pper
Suspendant	suspendre	VER:ppre
vuides	vuides	ADJ
rassasie	rassasier	VER:pres
Titie	Titie	VER:pper
sisiphe	sisiphe	NOM
Soeurs	sur	NOM
répandirent	répandre	VER:simp
recente	recente	ADJ
connoistre	connoistre	ADJ
obeir	obeir	NOM
supreme	supreme	ADJ
resserre	resserrer	VER:pres
prests	prests	NOM
apprehendant	apprehendant	VER:ppre
égarée	égarer	VER:pper
redevient	redevenir	VER:pres
croyant	croire	VER:ppre
tuë	tuë	VER:simp
étoufée	étoufée	VER:pper
Mary	Mary	NAM
prononcé	prononcer	VER:pper
abisme	abisme	NOM
Chien	chien	NOM
conqueste	conqueste	NOM
reduit	reduit	VER:pper
estat	estat	NOM
Fiere	Fiere	NOM
indiscrete	indiscrete	ADJ
vatant	vatant	NOM
préferoit	préferer	VER:impf
vangeance	vangeance	NOM
entreprit	entreprendre	VER:simp
innocente	innocent	ADJ
Infortunez	Infortunez	NOM
eprouverent	eprouver	VER:simp
severe	severe	NOM
fiere	fiere	NOM
Ennemi	ennemi	NOM
detester	detester	NOM
hymenée	hymenée	NOM
Objet	objet	NOM
gagner	gagner	VER:infi
dédaigner	dédaigner	VER:infi
Mesme	Mesme	NOM
ravissent	ravir	VER:pres
souhaitez	souhaiter	VER:pres
ouïr	ouïr	VER:infi
vergers	verger	NOM
Bergere	Bergere	NAM
Plaine	plaine	NOM
promene	promene	VER:pres
Lire	lire	NOM
Chesne	Chesne	NOM
Yeuse	yeuse	NOM
Cormier	cormier	NOM
Hestre	Hestre	NAM
Fresne	Fresne	NOM
Mirte	Mirte	NAM
Plane	plane	NOM
Ormeau	ormeau	NOM
mariez	marier	VER:pres
Bestes	Bestes	NOM
avancent	avancer	VER:pres
envy	envy	NOM
conspire	conspirer	VER:pres
insolente	insolent	ADJ
habillement	habillement	NOM
Troupe	troupe	NOM
échaufée	échaufée	VER:pper
Perfide	perfide	NOM
reservé	reservé	VER:pper
Vangeons	Vangeons	VER:pres
presomptueux	presomptueux	NOM
declare	declare	NOM
arrestée	arrestée	NOM
forçoit	forçer	VER:impf
deust	deust	NOM
vainc	vaincre	VER:pres
jouïr	jouïr	NOM
borne	borne	NOM
triomphante	triomphant	ADJ
reglé	reglé	VER:pper
frapez	frapez	VER:pres
étoufé	étoufé	VER:pper
commencent	commencer	VER:pres
épargnent	épargner	VER:pres
carnages	carnage	NOM
spatieux	spatieux	ADJ
Infortuné	infortuné	ADJ
entourer	entourer	VER:infi
idolatre	idolatre	NOM
amener	amener	VER:infi
butin	butin	NOM
endurcie	endurcir	VER:pper
adoucie	adoucir	VER:pper
ornement	ornement	NOM
Tirses	Tirses	NAM
destinez	destiner	VER:pres
tournez	tourner	VER:pres
accabler	accabler	VER:infi
aiguë	aiguë	ADJ
acharnement	acharnement	NOM
differens	differens	VER:pres
cultiver	cultiver	VER:infi
employoient	employer	VER:impf
beche	beche	NOM
entame	entame	NOM
remuë	remuë	NOM
fendre	fendre	VER:infi
charuë	charuë	NOM
naistre	naistre	ADJ
jetté	jetté	VER:pper
craignent	craindre	VER:pres
transporte	transporter	VER:pres
Bacchante	bacchante	NOM
tombre	tombre	VER:subp
étalant	étaler	VER:ppre
paroistre	paroistre	ADJ
répandent	répandre	VER:pres
feüillages	feüillages	NOM
expliquent	expliquer	VER:pres
travaillez	travailler	VER:pres
declarent	declarent	VER:simp
hautement	hautement	ADV
forcené	forcené	ADJ
deplorable	deplorable	ADJ
Sort	sort	NOM
afflige	affliger	VER:pres
confus	confus	ADJ
languissans	languissans	ADJ
appreste	appreste	VER:futu
soûleve	soûleve	VER:pres
déploye	déploye	VER:subp
instans	instans	NOM
degoutans	degoutans	NOM
Déja	Déja	NAM
découverte	découvrir	VER:pper
reconnoist	reconnoist	VER:cond
aisées	aisé	ADJ
Amans	aman	NOM
sçauroit	sçavoir	VER:impf
com	com	NOM
feme	feme	ADJ
joieusement	joieusement	NOM
diex	diex	NOM
nocoiement	nocoiement	NOM
sillent	siller	VER:pres
aleure	aleure	NOM
Aconie	Aconie	NAM
iere	iere	NOM
orpheus	orpheus	NOM
li	li	NOM
nouvele	nouvele	ADJ
joenne	joenne	ADJ
bele	bele	NOM
damoisele	damoisele	NOM
aport	aport	ADJ
deport	deport	NOM
aus	aus	NOM
contenus	contenir	VER:pper
done	done	ADJ
demoustrance	demoustrance	NOM
dolour	dolour	NOM
noceours	noceours	NOM
piours	piours	NOM
orent	orent	VER:subp
noue	noue	NOM
prin	prin	NOM
esbanoiant	esbanoiant	ADJ
préz	préz	NOM
Vint	venir	VER:simp
pastours	pastour	NOM
biaux	biaux	ADJ
envoisiez	envoisiez	VER:impf
proisiez	proisiez	VER:impf
proia	proia	NOM
noia	noia	VER:simp
adoner	adoner	VER:futu
habandoner	habandoner	NOM
fere	fere	NOM
requeist	requeist	VER:futu
fuioit	fuier	VER:impf
cil	cil	NOM
sivoit	siver	VER:impf
fu	fu	ADJ
Grant	Grant	VER:ppre
ot	ot	ADJ
pesance	pesance	NOM
sui	sui	VER:pper
afaire	afaire	NOM
quier	quier	NOM
Uns	un	NOM
bleça	bleça	VER:simp
mori	mori	VER:pper
bleceure	bleceure	NOM
Ore	ore	ADV
quidai	quidai	VER:simp
Ja	Ja	NAM
essoyé	essoyé	VER:pper
peuste	peuste	VER:subp
doloir	doloir	NOM
metre	metre	VER:pres
chaloir	chaloir	NOM
porroie	porroie	NOM
assaut	assaut	NOM
guerroie	guerroyer	VER:pres
auctorité	auctorité	NOM
dout	dout	VER:pres
si'y	si'y	NOM
devine	deviner	VER:pres
rapine	rapine	NOM
deus	deus	NOM
renomme	renommer	VER:pres
ment	mentir	VER:pres
pluto	pluto	ADJ
poi	poi	NOM
paour	paour	NOM
oscurté	oscurté	NOM
maleurté	maleurté	ADJ
feus	feu	ADJ
froidure	froidure	NOM
pri	pri	VER:pper
rendois	rendois	VER:pres
metois	metois	NOM
erbergage	erbergage	NOM
quar	quar	NOM
tendrois	tendrois	ADJ
solement	solement	NOM
demant	demant	VER:ppre
orendroit	orendrer	VER:impf
Ansi	Ansi	ADJ
dou	dou	ADJ
douçour	douçour	NOM
ploroient	plorer	VER:impf
entroblioient	entroblier	VER:impf
Ylion	Ylion	NAM
dejouste	dejouste	NOM
lessa	lessa	VER:simp
rou	rou	NOM
Sysiphus	Sysiphus	NAM
revait	revait	VER:subp
roiche	roiche	NOM
travaille	travailler	VER:pres
Thicius	Thicius	NAM
rebaille	rebaille	ADJ
rungier	rungier	NOM
guisier	guisier	NOM
espuisier	espuisier	ADJ
saaz	saaz	NOM
Belidienes	Belidienes	ADJ
renomee	renomee	NOM
voire	voire	ADV
doucour	doucour	NOM
ooient	oer	VER:impf
roïne	roïne	NOM
iex	iex	NOM
lermoiast	lermoiast	NOM
noiast	noiast	NOM
Orpheüs	Orpheüs	NAM
cloçant	cloçant	VER:ppre
alot	alot	NOM
ele	ele	ADJ
venent	venent	NOM
liez	lier	VER:pres
convenent	convenent	ADJ
outreement	outreement	NOM
retort	retort	VER:subi
gart	gart	NOM
arriere	arriere	NOM
istroit	istrer	VER:impf
roiste	roiste	ADJ
auques	auques	ADJ
porpris	porpris	NOM
sorpris	sorpris	NOM
desirreuz	desirreuz	NOM
douteuz	douteuz	NOM
venist	venist	NOM
mie	mie	NOM
torna	torna	VER:simp
cele	cele	NOM
refoye	refoye	NOM
esvanoye	esvanoye	VER:pres
Cil	cil	NOM
tent	tent	VER:futu
prent	prent	VER:simp
Cele	Cele	NAM
blasmer	blasmer	VER:infi
desrain	desrain	ADJ
rendi	rendi	VER:pper
noient	noyer	VER:pres
vait	vait	VER:impf
entrerrait	entrerrait	VER:cond
jors	jors	NOM
sor	sor	NOM
plorans	plorans	NOM
chetive	chetive	ADJ
boivre	boivre	VER:subp
duel	duel	ADJ
plours	plours	NOM
deulz	deulz	NOM
soustint	soustint	VER:simp
Redope	Redope	NOM
concubine	concubin|concubine	NOM
femeline	femeline	ADJ
ge	ge	VER:pper
pource	pource	NOM
cheï	cheï	NOM
fames	fames	NOM
haÿ	haÿ	NOM
voies	voie	NOM
pluiseur	pluiseur	ADJ
conquesterent	conquester	VER:simp
porent	porent	ADJ
joïr	joïr	VER:infi
deignoit	deigner	VER:impf
nulles	nul	ADJ
oïr	oïr	NOM
durement	durement	ADV
aprist	aprist	ADJ
ceulz	ceulz	NOM
joennes	joennes	ADJ
malles	malle	NOM
tuit	tuit	ADJ
Historial	historial	ADJ
recite	recite	NOM
dite	dit	ADJ
euridicen	euridicen	NOM
dame	dame	NOM
nocailles	nocailles	NOM
poestes	poestes	NOM
dolut	dolut	VER:simp
onques	onques	ADV
len	len	NOM
fame	fame	ADJ
perdi	perdi	VER:subi
cors	cor|cors	NOM
oir	oir	VER:futu
conté	conter	VER:pper
tonté	tonté	VER:pper
crueulz	crueulz	NOM
desmesure	desmesure	NOM
teulz	teulz	NOM
fet	fet	NOM
femelin	femelin	ADJ
esperance	esperance	NOM
ar	ar	VER:subi
regnable	regnable	ADJ
I	I	NUM
jointes	joindre	VER:pper
lignage	lignage	NOM
requiert	requérir	VER:pres
quele	quele	ADJ
seult	seult	ADJ
sivre	sivre	VER:infi
traire	traire	VER:infi
avirtuosité	avirtuosité	NOM
esloigne	esloigne	VER:subp
raisonable	raisonable	VER:simp
fuie	fuir	VER:subp
corant	corant	ADJ
gist	gist	NOM
souz	souz	VER:subi
delice	delice	NOM
envenime	envenimer	VER:pres
pechié	pechié	NOM
chiet	chiet	NOM
dolentement	dolentement	ADV
mannes	manne	NOM
abismes	abismes	NOM
]	]	PUN
paine	paine	NOM
pecheor	pecheor	NOM
tormente	tormente	NOM
dolereusement	dolereusement	VER:futu
macrobez	macrobez	VER:pres
meinent	meinent	NOM
let	let	NOM
orible	orible	ADJ
fluns	fluns	NOM
parverse	parverse	VER:pres
consciance	consciance	NOM
profitable	profitable	ADJ
saluable	saluable	ADJ
ams	ams	NOM
euz	euz	NOM
cheuz	cheuz	NOM
ler	ler	VER:subi
samble	samble	NOM
emprez	emprez	VER:pres
hayneus	hayneus	NOM
atayneus	atayneus	NOM
atayne	atayne	NOM
rencorde	rencorde	ADJ
despire	despire	NOM
foir	foir	NOM
atort	atort	NOM
hair	hair	NOM
cuer	cuer	VER:infi
destresce	destresce	ADJ
empres	empres	VER:subp
tristesce	tristesce	NOM
lace	lacer	VER:pres
affonde	affonde	ADJ
tault	tault	ADJ
spiritel	spiritel	ADJ
cort	cort	ADJ
Cochiris	Cochiris	NAM
ploreus	ploreus	NOM
dolereus	dolereus	VER:pres
dolours	dolours	NOM
Dou	Dou	NOM
flun	flun	ADJ
ardure	ardure	NOM
atise	atise	VER:subp
ardour	ardour	NOM
meschief	meschief	NOM
enivree	enivree	NOM
torment	torment	NOM
muert	muert	VER:cond
fam	fam	NOM
tamptalus	tamptalus	NOM
ave	ave	NOM
aaisier	aaisier	NOM
apaisier	apaisier	NOM
ardant	ardant	ADJ
enflame	enflame	VER:pres
affame	affamer	VER:pres
souffit	souffit	VER:simp
aquerre	aquerre	NOM
Maint	maint	PRO:IND
ensi	ensi	VER:pper
tormenté	tormenté	NOM
volenté	volenté	VER:pper
aire	aire	NOM
tens	tens	NOM
étent	étent	ADJ
dignitez	dignitez	VER:pres
mondaine	mondain	ADJ
honor	honor	NOM
aquierent	aquier	VER:simp
hautesces	hautesces	NOM
honors	honors	NOM
noblesces	noblesces	NOM
trebuchent	trebuchent	VER:pres
soudainement	soudainement	ADV
prosperité	prosperité	NOM
val	val	NOM
vilité	vilité	NOM
moe	moe	ADJ
tornoisant	tornoisant	NOM
otent	otent	ADJ
foloiant	foloiant	ADJ
porveance	porveance	NOM
demaine	demaine	ADJ
selonc	selonc	NOM
variabletez	variabletez	NOM
decevabletez	decevabletez	NOM
seer	seer	NOM
voutoirs	voutoirs	NOM
runge	runge	NOM
entraille	entraille	NOM
baille	baille	NOM
doutance	doutance	VER:ppre
roong	roong	NOM
home	home	NOM
amort	amort	NOM
desconveigne	desconveigne	NOM
prepeigne	prepeigne	NOM
pecheour	pecheour	NOM
roonge	roonge	NOM
lesse	lesse	NOM
lessier	lessier	VER:infi
can	can	ADJ
mauvescie	mauvescie	NOM
malice	malice	NOM
griez	griez	VER:cond
mors	mors	NOM
confon	confon	NOM
celes	celes	NOM
vessel	vessel	NOM
sçuent	sçuent	VER:pres
aviegne	aviegne	ADJ
vessiaux	vessiaux	NOM
remaigne	remaigne	VER:subp
iaue	iaue	NOM
escolorable	escolorable	ADJ
denotent	denotent	VER:pres
dampnable	dampnable	ADJ
ordive	ordive	NOM
lecheours	lecheours	NOM
yunais	yunais	NOM
veneours	veneours	NOM
vuelent	vuelent	VER:pres
engoler	engoler	VER:infi
mondains	mondain	NOM
fuiable	fuiable	ADJ
trespassant	trespassant	ADJ
escoulourable	escoulourable	NOM
assiduel	assiduel	ADJ
gluton	gluton	ADJ
devorant	devorant	NOM
vaudroient	vaudrer	VER:impf
glotonner	glotonner	VER:infi
entonner	entonner	VER:infi
vessiel	vessiel	NOM
painent	painent	VER:subp
querer	querer	VER:infi
saoulleront	saoulleront	VER:futu
beu	beu	INT
embeu	embeu	NOM
conviegne	conviegne	ADJ
fains	fains	NOM
ramegne	ramegne	ADJ
donques	donques	ADV
avancier	avancier	NOM
pert	pert	ADJ
entente	entente	NOM
demoret	demoret	NOM
gloute	gloute	ADJ
pance	pance	NOM
nes	nes	ADJ
souffissance	souffissance	NOM
constenir	constenir	VER:infi
glotonie	glotonie	NOM
descnet	descnet	ADJ
mest	mest	NOM
querre	querre	NOM
trere	trere	NOM
pecherresse	pecherresse	ADJ
pachié	pachié	NOM
assavoir	assavoir	VER:infi
peril	peril	NOM
meschie	meschie	NOM
redargne	redargne	VER:pres
pechie	pechie	NOM
apoline	apoline	ADJ
dinspnaction	dinspnaction	NOM
visite	visite	NOM
espire	espire	VER:pres
pechiez	pechiez	NOM
atire	atire	VER:infi
manifeste	manifeste	ADJ
perilz	perilz	NOM
requinse	requinse	VER:pper
delivree	delivree	NOM
penitance	penitance	NOM
confesse	confesse	NOM
esforce	esforce	VER:pres
duifer	duifer	VER:infi
vivifier	vivifier	VER:infi
cui	cui	NOM
mesquint	mesquint	ADJ
rabandone	rabandone	ADJ
felonie	felonie	NOM
avilité	avilité	NOM
derreniere	derreniere	NOM
ensuivre	ensuivre	VER:infi
vestornee	vestornee	NOM
refleschie	refleschie	NOM
retornee	retornee	NOM
fole	fole	ADJ
charner	charner	NOM
plesir	plesir	NOM
fragilité	fragilité	NOM
imiquité	imiquité	NOM
escalorge	escalorge	VER:subp
derechies	derechies	NOM
meschies	meschies	NOM
errour	errour	ADJ
desreniere	desreniere	NOM
quer	quer	VER:infi
permeraine	permeraine	NOM
natent	natent	VER:subp
refu	refu	ADJ
vueur	vueur	NOM
tenebreus	tenebreus	NOM
occurci	occurci	ADJ
veult	veult	ADJ
osoi	osoi	NOM
revevoir	revevoir	NOM
connoissance	connoissance	NOM
alleforie	alleforie	NOM
sentence	sentence	NOM
letre	letre	ADJ
oistes	oistes	ADJ
convent	convent	NOM
regardoit	regarder	VER:impf
atainsist	atainsist	ADJ
retraisist	retraisist	NOM
poetes	poetes	ADJ
saisist	saisist	NOM
larion	larion	NOM
resoner	resoner	VER:infi
lA	lA	VER:futu
doner	doner	VER:infi
porprirent	porprirent	VER:simp
Vendant	vendre	VER:ppre
refflier	refflier	NOM
teil	teil	NOM
folz	folz	NOM
lorier	lorier	NOM
corneillier	corneillier	NOM
firnses	firnses	NOM
morier	morier	NOM
chesans	chesans	NOM
sauce	sauce	NOM
arable	arable	ADJ
verdour	verdour	NOM
pardurable	pardurable	ADJ
peschier	peschier	ADJ
mirte	mirte	NOM
tenure	tenure	NOM
genest	genest	NOM
nest	nest	ADJ
figiers	figiers	VER:subp
ins	ins	NOM
jatris	jatris	NOM
aubepins	aubepins	NOM
pluisors	pluisors	NOM
guises	guise	NOM
portants	portant	ADJ
nois	nois	NOM
cornies	cornies	NOM
ensement	ensement	NOM
cel	cel	VER:pper
Cybeles	Cybeles	NAM
Li	li	NOM
avent	avent	NOM
enfes	enfes	VER:pres
ama	ama	ADJ
dementres	dementres	ADJ
vesqui	vesqui	NOM
poeste	poeste	NOM
assamble	assamble	VER:pres
sauvetine	sauvetine	NOM
oisiaux	oisiaux	ADJ
atrempoit	atremper	VER:impf
ententivement	ententivement	NOM
acorde	acorde	VER:pres
chascune	chascune	NOM
acrot	acrot	NOM
descort	descort	NOM
acordes	acordes	ADJ
cielz	cielz	NOM
jovencieulz	jovencieulz	NOM
ordeneement	ordeneement	NOM
vueil	vueil	NOM
espondre	espondre	NOM
harpeour	harpeour	NOM
chateour	chateour	NOM
requerre	requerre	VER:futu
regart	regart	NOM
dolousement	dolousement	NOM
assambler	assambler	VER:infi
compaigne	compaigne	ADJ
sauvecine	sauvecine	NOM
destorre	destorre	NOM
entens	entens	NOM
ploree	ploree	ADJ
recouvree	recouvree	NOM
plorer	plorer	VER:infi
dementer	dementer	VER:infi
ester	ester	NOM
delitablement	delitablement	NOM
fenir	fenir	NOM
not	not	ADJ
douctrine	douctrine	NOM
atraire	atraire	ADJ
alecher	alecher	NOM
primes	prime	ADJ
amortelement	amortelement	NOM
pecher	pecher	ADJ
confermer	confermer	VER:infi
dessoi	dessoi	NOM
atrraoit	atrraer	VER:impf
example	example	NOM
retraoit	retraer	VER:impf
males	mal	ADJ
mouvoient	mouver	VER:impf
tenoient	tener	VER:impf
femes	femes	NOM
blasmoient	blasmer	VER:impf
tesmoignoit	tesmoigner	VER:impf
miex	miex	NOM
fasoit	faser	VER:impf
plesoit	pleser	VER:impf
olui	olui	NOM
amusoient	amuser	VER:impf
valetons	valeter	VER:pres
abusoient	abuser	VER:impf
orine	orine	NOM
allegoire	allegoire	NOM
atrait	atrait	ADJ
douz	douz	VER:subi
melodieuz	melodieuz	NOM
delitables	delitables	ADJ
nis	nis	VER:impf
devins	devenir	VER:simp
ez	ez	VER:simp
engresse	engresse	NOM
forsenez	forsenez	NOM
avoueint	avoueint	VER:pres
enchantant	enchanter	VER:ppre
atraiant	atraiant	ADJ
corent	corent	VER:simp
aatine	aatine	NOM
serient	serient	VER:subp
adversier	adversier	NOM
traitour	traitour	NOM
desutaire	desutaire	NOM
bait	bait	VER:impf
amusant	amusant	ADJ
acusant	acusant	ADJ
despise	despise	VER:subp
longes	longe	NOM
commes	commes	NOM
avilonies	avilonies	NOM
condonues	condonues	ADJ
honies	honies	NOM
prisier	prisier	VER:impf
touz	touz	NOM
desprisies	desprisies	NOM
lancié	lancié	VER:pper
malmis	malmis	NOM
blecié	blecié	ADJ
fueillie	fueillie	NOM
Ausi	Ausi	ADJ
humelier	humelier	NOM
chanteour	chanteour	ADJ
desuerie	desuerie	NOM
forsenerie	forsenerie	NOM
queriens	queriens	ADJ
poist	poist	NOM
entr'eles	entr'eles	NOM
crierresse	crierresse	NOM
tempire	tempire	NOM
bruiresce	bruiresce	VER:subp
buisines	buisine	NOM
sonant	sonant	VER:ppre
quen	quen	NOM
oist	oist	NOM
tonnant	tonnant	ADJ
jetent	jetent	VER:pres
sanc	sanc	ADJ
pius	pius	NOM
sorent	sorent	ADJ
embrevoient	embrever	VER:impf
mui	mui	VER:pper
soustrait	soustraire	VER:pper
Tint	tenir	VER:simp
mestre	mestre	NOM
trayer	trayer	NOM
ronc	ronc	ADJ
ennuyer	ennuyer	VER:infi
mercu	mercu	ADJ
felonnessement	felonnessement	NOM
laidir	laidir	NOM
vilainement	vilainement	ADV
faignent	faignent	VER:subp
virotent	virotent	VER:subp
oisiel	oisiel	ADJ
noctru	noctru	NOM
entr'eulz	entr'eulz	NOM
ferue	ferue	ADJ
deplument	deplument	NOM
depelent	depelent	NOM
batent	batent	VER:subp
tuepelent	tuepelent	VER:subp
cers	cers	NOM
desaroient	desarer	VER:impf
galetes	galetes	NOM
laidures	laidures	NOM
fallissent	fallissent	VER:subi
poissent	poisser	VER:pres
pestre	pestre	ADJ
forsenage	forsenage	NOM
Prez	Prez	VER:pres
illuec	illuec	ADJ
gaaignage	gaaignage	NOM
bues	buer	VER:pres
gaaignors	gaaignors	NOM
multepliabe	multepliabe	ADJ
atante	atante	ADJ
embreveusement	embreveusement	VER:simp
enragiement	enragiement	NOM
laboreour	laboreour	ADJ
contr'euz	contr'euz	VER:subi
uient	uient	NOM
lessent	lessent	VER:subi
laborage	laborage	NOM
graaing	graaing	NOM
mehaing	mehaing	NOM
esparpeilliez	esparpeilliez	NOM
desvees	desvees	NOM
peilliez	peilliez	NOM
forremens	forremens	NOM
culture	culture	NOM
asseul	asseul	NOM
troe	troe	ADJ
arpe	arpe	NOM
maiil	maiil	NOM
piot	piot	NOM
retornent	retornent	VER:pres
ireement	ireement	NOM
dampnement	dampnement	NOM
devin	devin	NOM
atendoit	atender	VER:impf
du'il	du'il	ADJ
vaudrent	vaudrent	VER:cond
Murtri	Murtri	NAM
reprouche	reprouche	VER:pres
sainte	saint	ADJ
oisiaus	oisiaus	NOM
enchater	enchater	NOM
seuree	seuree	ADJ
mainte	maint	PRO:IND
lerme	lerme	NOM
connoissoient	connoisser	VER:impf
rosches	rosches	NOM
senefiance	senefiance	NOM
plorerent	plorer	VER:simp
entrurent	entrurent	VER:simp
leuz	leuz	NOM
Ci	ci	ADV
renon	renon	NOM
recut	recut	VER:simp
merveilleus	merveilleus	NOM
flotant	flotant	ADJ
ploreuz	ploreuz	NAM
donoit	doner	VER:impf
resonnoient	resonner	VER:impf
plorable	plorable	ADJ
chiez	chier	VER:pres
bonterent	bonter	VER:simp
Lesbe	Lesbe	NAM
issent	issent	ADJ
Phebz	Phebz	NAM
demorer	demorer	VER:infi
chies	chier	VER:pres
rescorre	rescorre	NOM
volt	volt	NOM
corre	corre	NOM
phebz	phebz	NOM
faiture	faiture	NOM
demorance	demorance	NOM
devalee	devalee	ADJ
Vit	vivre	VER:pres
valle	valle	NOM
buen	buen	ADJ
reconneuz	reconneuz	NOM
touva	touva	VER:simp
desirree	desirree	NOM
embrace	embrace	NOM
resgarde	resgarde	NOM
maleur	maleur	NOM
grevant	grever	VER:ppre
oeus	oeus	NOM
prejudice	prejudice	NOM
tollu	tollu	NOM
amoureus	amoureus	NOM
ust	ust	NOM
donq	donq	NOM
faus	faus	NOM
pinsee	pinsee	NOM
herbage	herbage	NOM
tot	tot	ADJ
trespassa	trespassa	VER:simp
poure	poure	VER:pres
espousee	espousee	NOM
ploré	ploré	VER:pper
experte	expert	ADJ
animee	animee	NOM
enfumee	enfumee	NOM
Royne	Royne	NOM
estimee	estimee	NOM
orphee	orphee	NOM
essis	essis	VER:pper
bravement	bravement	ADV
mesmement	mesmement	NOM
oiseaus	oiseaus	NOM
volent	voler	VER:pres
Cas	cas	NOM
mervueillous	mervueillous	NOM
urlans	urlans	NOM
devers	devers	PRP
meinte	meinte	NOM
Baccante	baccante	NOM
assaillant	assaillant	ADJ
tresfurieusement	tresfurieusement	NOM
melodieusement	melodieusement	NOM
piteus	piteus	ADJ
compleingnant	compleingnant	VER:ppre
resonne	resonne	ADJ
murmur	murmur	NOM
correspond	correspondre	VER:pres
pleints	pleints	NOM
entonne	entonner	VER:pres
respond	respond	VER:pres
legerement	légèrement	ADV
vestu	vestu	ADJ
Pourpre	pourpre	NOM
intervalle	intervalle	NOM
droict	droict	ADJ
Thracien	thracien	ADJ
devalle	devalle	NOM
monstré	monstré	NOM
allumee	allumee	NOM
esclairer	esclairer	VER:infi
semblablement	semblablement	ADV
espandit	espandit	VER:simp
deploree	deploree	NOM
entrant	entrer	VER:ppre
tenarienne	tenarienne	ADJ
ausquels	ausquels	ADJ
sejours	sejours	NOM
sonnant	sonner	VER:ppre
puissans	puissans	ADJ
habitateurs	habitateurs	NOM
dessoubs	dessoubs	NOM
sçavons	sçavons	VER:pres
requis	requérir	VER:pper
licite	licite	ADJ
equitable	equitable	NOM
recité	recité	NOM
fay	fay	VER:subi
Regnes	Regnes	NOM
outrageux	outrageux	ADJ
piquee	piquee	ADJ
travaillé	travailler	VER:pper
Cupidon	cupidon	NOM
notoire	notoire	ADJ
mentir	mentir	VER:infi
supply	supply	VER:subi
detestables	detestables	NOM
espouventables	espouventables	NOM
sejourne	sejourne	VER:pres
deubs	deubs	NOM
Humains	humain	NOM
perdurable	perdurable	ADJ
fruition	fruition	NOM
jurisdition	jurisdition	NOM
accomply	accomply	NOM
meur	meur	ADJ
octroyez	octroyer	VER:pres
preordonné	preordonné	VER:pper
prenez	prendre	VER:pres
soulas	soulas	NOM
chorde	chorde	NOM
espandent	espandent	VER:pres
pleur	pleur	NOM
souspirant	souspirant	VER:ppre
Semblablement	semblablement	ADV
Roue	roue	NOM
descirer	descirer	VER:infi
Foye	Foye	NAM
Titius	Titius	NAM
puyser	puyser	VER:infi
cessante	cessant	ADJ
Manoir	manoir	NOM
hydeuses	hydeuses	ADJ
escoutant	escoutant	NOM
chordes	chorde	NOM
piteuses	piteux	ADJ
excusent	excuser	VER:pres
appellant	appellant	ADJ
survint	survenir	VER:simp
recentement	recentement	NOM
depart	depart	NOM
abstienne	abstenir	VER:subp
allée	aller	VER:pper
demeurera	demeurer	VER:futu
effaict	effaict	NOM
montee	montee	NOM
Desja	Desja	NAM
extremité	extremité	NOM
limité	limiter	VER:pper
derechef	derechef	ADV
brad	brad	NOM
attaincte	attaincte	ADJ
use	user	VER:pres
plaincte	plaincte	ADJ
complaire	complaire	VER:infi
secourir	secourir	VER:infi
apperceut	apperceut	VER:pres
lié	lier	VER:pper
Olenus	olenus	NOM
Lethea	Lethea	NAM
preferer	preferer	VER:infi
aymée	aymée	ADJ
transformée	transformer	VER:pper
sousient	sousient	VER:pres
Stygiale	Stygiale	ADJ
gardeur	gardeur	NOM
repoulsa	repoulsa	VER:simp
soucy	soucy	NOM
severité	severité	NOM
Rhodopé	Rhodopé	NOM
Jà	Jà	ABR
sejournant	sejournant	VER:ppre
abstenu	abstenir	VER:pper
advenu	advenir	VER:pper
pourautant	pourautant	ADJ
loyalle	loyalle	NOM
dict	dict	NOM
gracieuse	gracieux	ADJ
sonner	sonner	VER:infi
gland	gland	NOM
Escue	Escue	ADJ
Plan	plan	NOM
Alisier	alisier	NOM
petis	petis	NOM
Bruyere	Bruyere	NAM
Aulnes	aulne	NOM
Pommiers	pommier	NOM
Ormes	orme	NOM
Palme	palme	NOM
los	los	NOM
produict	produict	NOM
Ciprés	Ciprés	NAM
present	present	NOM
aymé	aymé	ADJ
Art	Art	NAM
renommé	renommer	VER:pper
subjecte	subjecte	NOM
Harpe	Harpe	NAM
encline	enclin	ADJ
sagette	sagette	NOM
émouvoit	émouver	VER:impf
vestues	vestues	ADJ
chans	chans	NOM
dicts	dicts	NOM
frappa	frapper	VER:simp
saincts	saincts	ADJ
humblement	humblement	ADV
entreprises	entreprise	NOM
encontre	encontre	ADV
cry	cry	NOM
resonnance	resonnance	NOM
repugnance	repugnance	NOM
rigoureuses	rigoureux	ADJ
vermeille	vermeil	ADJ
captif	captif	ADJ
serf	serf	ADJ
assailly	assailly	NOM
austerement	austerement	NOM
faicts	faicts	NOM
fascher	fascher	VER:infi
félon	félon	ADJ
maints	maints	VER:pper
labourer	labourer	VER:infi
Joug	joug	NOM
obeissant	obeissant	ADJ
soubs	soubs	NOM
utilité	utilité	NOM
assemblees	assemblees	ADJ
troublees	troublees	ADJ
labourage	labourage	NOM
houlete	houlete	ADJ
Soc	soc	NOM
Ereau	Ereau	NOM
souhaitte	souhaitte	VER:subp
parfaict	parfaict	ADJ
privileges	privileges	NOM
amollisoit	amolliser	VER:impf
ramages	ramage	NOM
deploré	deploré	NOM
despouillé	despouillé	VER:pper
regretté	regretter	VER:pper
Mesmes	Mesmes	NAM
habit	habit	NOM
Nayades	Nayades	NAM
espandus	espandus	VER:pper
estendus	estendus	NOM
complainte	complainte	NOM
funebre	funebre	ADJ
feit	feit	VER:simp
arrosé	arroser	VER:pper
notable	notable	ADJ
leschoit	lescher	VER:impf
poetiques	poetiques	ADJ
empescha	empescha	VER:simp
transmué	transmuer	VER:pper
Élisée	Élisée	NAM
advisee	advisee	NOM
aproche	aproche	NOM
mutuellement	mutuellement	ADV
ores	ores	ADV
estonner	estonner	VER:infi
pourmener	pourmener	VER:infi
suyt	suyt	VER:subi
plaisance	plaisance	NOM
doubtance	doubtance	NOM
