Possible	ADJ	possible
là-bas	ADV	là-bas
Dez	VER:pres	Dez
est-cecy	ADJ	est-cecy
meffaits	NOM	meffaits
tourmetns	NOM	tourmetns
Suppliez	VER:pres	supplier
pardonnant	VER:ppre	pardonner
loyal	ADJ	loyal
Va-t'en	NOM	Va-t'en
va-t	VER:simp	va-t
Va-t	VER:pres	Va-t
a-t	ADJ	a-t
-ci	ADV	-ci
moi-mème	NOM	moi-mème
font-t	VER:impf	font-t
Sur-le-champ	ADV	sur-le-champ
habitoit	VER:subi	habitoit
spacieuse	ADJ	spacieux
parvenues	VER:pper	parvenir
e	VER:simp	e
crin-crin	NOM	crin-crin
endormons-nous	NOM	endormons-nous
Rejoins-m'y	NOM	Rejoins-m'y
dira-t	VER:simp	dira-t
mouillees	NOM	mouillees
esploré	NOM	esploré
tablettes	NOM	tablette
stance	NOM	stance
hirsutes	ADJ	hirsute
ouragans	NOM	ouragan
assouplis	VER:pres	assouplir
Éole	NOM	Éole
sanglottant	VER:ppre	sanglottant
Fastes	NOM	faste|fastes
reflété	VER:pper	refléter
Boitant	VER:ppre	boiter
ferait-il-pas	VER:cond	ferait-il-pas
est-à-dire	ADV	est-à-dire
taillé	VER:pper	tailler
cône-	NOM	cône-
elles-	NOM	elles-
precipitantement	NOM	precipitantement
mussé	VER:pper	musser
soubz	NOM	soubz
tardoit	VER:pres	tardoit
mavortie	VER:pper	mavortie
espargnoit	NOM	espargnoit
provinces	NOM	province
pucelles	ADJ	pucelle
procelles	NOM	procelles
progeniteurs	ADJ	progeniteurs
frequentant	VER:ppre	frequentant
enrichiras	VER:futu	enrichir
décrets	NOM	décret
postule	VER:pres	postuler
goûtez	VER:pres	goûter
q'un	ADJ	q'un
ouranienne	NOM	ouranienne
picqueure	NOM	picqueure
voiage	NOM	voiage
entre-laissez	VER:pres	entre-laissez
-	PUN	-
léoparde	ADJ	léoparde
laisse-t	NOM	laisse-t
Brrr	NAM	Brrr
semi-obscurité	NOM	semi-obscurité
en-haut	ADV	en-haut
m	VER:simp	m
intuitive	ADJ	intuitif
parviendrions	VER:cond	parvenir
devrons-nous	VER:cond	devrons-nous
Érymanthe	NOM	Érymanthe
Murcus	NAM	Murcus
sur-tout	NOM	sur-tout
puisqu'à	ADJ	puisqu'à
Pompe	NOM	pompe
assure-t	VER:simp	assure-t
Bornons-nous	NOM	Bornons-nous
amour-propre	NOM	amour-propre
Sème-t	VER:cond	Sème-t
Chef-d'oeuvre	NOM	chef-d'uvre
maison-ops	NOM	maison-ops
inventez	VER:pres	inventer
oeillets	NOM	illet
arc-en-Ciel	NOM	arc-en-ciel
sembliez	VER:impf	sembler
Depeins	NAM	Depeins
eloquentes	ADJ	eloquentes
secoüant	VER:ppre	secoüant
Vieil	ADJ	vieux
regarderez	VER:futu	regarder
vomissant	VER:ppre	vomir
Scylle	NAM	Scylle
transfomée	ADJ	transfomée
Nesmée	NAM	Nesmée
conquerir	VER:infi	conquerir
fangeuses	ADJ	fangeux
verray-encore	VER:cond	verray-encore
champestres	NOM	champestres
soustienne	VER:subp	soustienne
possedes	NOM	possedes
Hardiesse	NOM	hardiesse
oresnavant	NOM	oresnavant
Puisqu'à	ABR	Puisqu'à
aspirera-t-elle	VER:subp	aspirera-t-elle
bien-	NOM	bien-
.jts	ADJ	.jts
suppléer	VER:infi	suppléer
ramasser	VER:infi	ramasser
elle-	NOM	elle-
Silêne	NAM	Silêne
goufres	NOM	goufres
fera-t	VER:cond	fera-t
Ôtons	VER:pres	ôter
Portez-ici	VER:pper	Portez-ici
petit-à-petit	NOM	petit-à-petit
000	NUM	@card@
Pourra-t	VER:cond	Pourra-t
sauce-claire	NOM	sauce-claire
sang-froid	NOM	sang-froid
préviens-nous	NOM	préviens-nous
très-pénible	NOM	très-pénible
avons-	VER:impf	avons-
dit-	NOM	dit-
ç'en	NOM	ç'en
lui-	NOM	lui-
Attire	VER:pres	attirer
vegetative	NOM	vegetative
demi-douzaine	NOM	demi-douzaine
auto-destruction	NOM	auto-destruction
mot-force	NOM	mot-force
Parti-Troupeau-Unique	NOM	Parti-Troupeau-Unique
avant-goût	NOM	avant-goût
croira-t	VER:futu	croira-t
avant-dernière	ADJ	avant-dernier
ré-symbolise	VER:subp	ré-symbolise
	PUN:cit	
vingt-deuxième	NOM	vingt-deuxième
avouë	VER:simp	avouë
sincerement	NOM	sincerement
transformez	VER:pres	transformer
favori	ADJ	favori
jusqu	NOM	jusqu
devaler	VER:infi	devaler
mesloit	VER:pres	mesloit
envenimé	VER:pper	envenimer
jourduy	NOM	jourduy
hont	VER:futu	hont
complaint	VER:pres	complaindre
dolouse	VER:pres	dolouse
prou	ADV	prou
aler	VER:infi	aler
infernaulz	ADJ	infernaulz
arçon	NOM	arçon
harpant	VER:ppre	harper
yinais	NOM	yinais
ra	NOM	ra
moi-seul	NOM	moi-seul
Quoiqu'elle	NAM	Quoiqu'elle
c	VER:pper	c
terrassés	VER:pper	terrasser
dominateurs	ADJ	dominateur
enfantent	VER:pres	enfanter
Soutienne	VER:subp	soutenir
Dicte-nous	NAM	Dicte-nous
revien	NOM	revien
dra	VER:futu	dra
cognons	VER:pres	cogner
anarchiste	NOM	anarchiste
Casser	VER:infi	casser
soulagera	VER:futu	soulager
Hep	INT	hep
Remettez-le	NOM	Remettez-le
maltraite	VER:pres	maltraiter
acceptera-t-il	NOM	acceptera-t-il
mètre	NOM	mètre
automatique	ADJ	automatique
enroulera	VER:futu	enrouler
Jeu	NOM	jeu
reportez	VER:pres	reporter
principal	ADJ	principal
Asseyez	VER:pres	asseoir
trichez	VER:pres	tricher
contredise	VER:subp	contredire
sauverai	VER:futu	sauver
parvenez	VER:pres	parvenir
recommenceront	VER:futu	recommencer
Plaît-il	NOM	Plaît-il
politesse	NOM	politesse
Auquel	PRO:REL	auquel
Coudryer	NAM	Coudryer
Fraysne	NOM	Fraysne
Piques	NOM	pique
Tiller	VER:infi	tiller
verdissant	ADJ	verdissant
neuds	NOM	neuds
théurgique	ADJ	théurgique
dionysiaque	ADJ	dionysiaque
dirigeaient	VER:impf	diriger
commandaient	VER:impf	commander
enfilades	NOM	enfilade
croupes	NOM	croupe
onduleuses	ADJ	onduleux
déroulaient	VER:impf	dérouler
cirques	NOM	cirque
enchevêtraient	VER:impf	enchevêtrer
chauves-souris	NOM	chauves-souris
en-allée	NOM	en-allée
opsa	VER:simp	opsa
opsest	NOM	opsest
inopsest	NOM	inopsest
Lamaison-opsest	NAM	Lamaison-opsest
opsdéfend	VER:pres	opsdéfend
inopsdéfend	NOM	inopsdéfend
opsbanni	VER:pper	opsbanni
inopsvoudra	NOM	inopsvoudra
auctoritàsse	NOM	auctoritàsse
ilefaut	NOM	ilefaut
Argos'éloigner	NAM	Argos'éloigner
cesplus	NOM	cesplus
jamaisqui	ADJ	jamaisqui
Argoavec	NAM	Argoavec
Argoglisse	NAM	Argoglisse
Argofend	NAM	Argofend
Argoa	NAM	Argoa
Argon'a	NAM	Argon'a
Argosi	NOM	Argosi
Argoavancera	VER:futu	Argoavancera
Argone	NOM	Argone
Argopour	NOM	Argopour
Argoqu'à	ABR	Argoqu'à
Argoet	NAM	Argoet
Argoseront	NAM	Argoseront
vuet	ADJ	vuet
Orphéel'appelloit	NAM	Orphéel'appelloit
Enviedans	NOM	Enviedans
Orphéela	NAM	Orphéela
Eurydiceayant	VER:ppre	Eurydiceayant
Orphéeayant	ADJ	Orphéeayant
Aristéequi	NAM	Aristéequi
Orphéearrive	NOM	Orphéearrive
Orphéeest	NAM	Orphéeest
Eurydicepour	NAM	Eurydicepour
etillecung	ADJ	etillecung
Leurstambours	NOM	Leurstambours
gosiershérissés	NOM	gosiershérissés
monépouse	NOM	monépouse
demonvoyage	NOM	demonvoyage
cettefaveur	NOM	cettefaveur
nombreuxque	ADJ	nombreuxque
quise	NOM	quise
mortsqu'un	NOM	mortsqu'un
telque	ADJ	telque
restéssans	VER:simp	restéssans
laroulait	VER:impf	laroulait
savoix	ADJ	savoix
etillec	ADJ	etillec
cartous	NOM	cartous
insi	VER:pper	insi
p	NOM	p
ntour	NOM	ntour
loistet	NOM	loistet
nsi	NOM	nsi
quenni	VER:pper	quenni
ales	NOM	ale
démencepardonnable	ADJ	démencepardonnable
estingénium	NOM	estingénium
devenirops	NOM	devenirops
argo	NOM	argo
entrerorphée	ADJ	entrerorphée
verseurydice	NOM	verseurydice
ouranos	NOM	ouranos
entrerOrphée	ADJ	entrerOrphée
versEurydice	NOM	versEurydice
